,Movie,Production Budget,Domestic Gross,Worldwide Gross,Profit,ROI,Year,nameYear
5677,the birth of a nation,110000,10000000,11000000,10890000,100.0,1915,the birth of a nation1915
5523,intolerance,385907,0,0,-385907,0.0,1916,intolerance1916
5614,20000 leagues under the sea,200000,8000000,8000000,7800000,40.0,1916,20000 leagues under the sea1916
5683,over the hill to the poorhouse,100000,3000000,3000000,2900000,30.0,1920,over the hill to the poorhouse1920
4569,benhur a tale of the christ,3900000,9000000,9000000,5100000,2.3076923076923075,1925,benhur a tale of the christ1925
5606,the big parade,245000,11000000,22000000,21755000,89.79591836734694,1925,the big parade1925
4984,wings,2000000,0,0,-2000000,0.0,1927,wings1927
5524,the broadway melody,379000,2800000,4358000,3979000,11.49868073878628,1929,the broadway melody1929
4559,hells angels,4000000,0,0,-4000000,0.0,1930,hells angels1930
5423,mata hari,558000,900000,900000,342000,1.6129032258064515,1931,mata hari1931
5618,she done him wrong,200000,2000000,2000000,1800000,10.0,1933,she done him wrong1933
5396,king kong,672000,10000000,10000650,9328650,14.881919642857143,1933,king kong1933
5502,42nd street,439000,1438000,2281000,1842000,5.195899772209567,1933,42nd street1933
5537,it happened one night,325000,2500000,2500000,2175000,7.6923076923076925,1934,it happened one night1934
5405,top hat,609000,1782000,3202000,2593000,5.257799671592775,1935,top hat1935
5180,the charge of the light brigade,1200000,0,0,-1200000,0.0,1936,the charge of the light brigade1936
5131,san francisco,1300000,2868000,5273000,3973000,4.056153846153846,1936,san francisco1936
5097,modern times,1500000,163245,199747,-1300253,0.13316466666666665,1936,modern times1936
5117,snow white and the seven dwarfs,1488000,184925486,184925486,183437486,124.27788037634409,1937,snow white and the seven dwarfs1937
4917,alexanders ragtime band,2000000,4000000,4000000,2000000,2.0,1938,alexanders ragtime band1938
5049,you cant take it with you,1644000,4000000,4000000,2356000,2.4330900243309004,1938,you cant take it with you1938
4788,the wizard of oz,2777000,34063405,34305476,31528476,12.353430320489737,1939,the wizard of oz1939
5068,mr smith goes to washington,1500000,9000000,9000000,7500000,6.0,1939,mr smith goes to washington1939
4567,gone with the wind,3900000,198680470,390525192,386625192,100.13466461538462,1939,gone with the wind1939
4901,boom town,2000000,9172000,9172000,7172000,4.586,1940,boom town1940
5146,rebecca,1288000,6000000,6002370,4714370,4.6602251552795035,1940,rebecca1940
4868,fantasia,2280000,83320000,83320000,81040000,36.54385964912281,1940,fantasia1940
4867,pinocchio,2289247,84300000,84300000,82010753,36.82433568767372,1940,pinocchio1940
5154,how green was my valley,1250000,0,0,-1250000,0.0,1941,how green was my valley1941
5668,cat people,134000,4000000,8000000,7866000,59.701492537313435,1942,cat people1942
5346,bambi,858000,102797000,268000000,267142000,312.35431235431236,1942,bambi1942
4799,a guy named joe,2627000,5363000,5363000,2736000,2.041492196421774,1943,a guy named joe1943
5209,casablanca,1039000,10462500,10496855,9457855,10.102844080846968,1943,casablanca1943
4858,bathing beauty,2361000,3500000,3500000,1139000,1.4824227022448115,1944,bathing beauty1944
4243,wilson,5200000,2000000,2000000,-3200000,0.38461538461538464,1944,wilson1944
4874,the valley of decision,2160000,9132000,9132000,6972000,4.227777777777778,1945,the valley of decision1945
5148,the lost weekend,1250000,11000000,11000000,9750000,8.8,1945,the lost weekend1945
5073,spellbound,1500000,7000000,7000000,5500000,4.666666666666667,1945,spellbound1945
4877,the best years of our lives,2100000,23600000,23600000,21500000,11.238095238095237,1946,the best years of our lives1946
4889,notorious,2000000,24464742,24464742,22464742,12.232371,1946,notorious1946
4130,duel in the sun,6000000,20400000,20400000,14400000,3.4,1946,duel in the sun1946
4774,the harvey girls,2931000,4100000,4100000,1169000,1.3988399863527807,1946,the harvey girls1946
4660,itâs a wonderful life,3180000,6600000,10768908,7588908,3.3864490566037735,1946,itâs a wonderful life1946
4902,gentlemans agreement,2000000,7800000,7800000,5800000,3.9,1947,gentlemans agreement1947
4696,red river,3000000,9012000,9012000,6012000,3.004,1948,red river1948
4581,the pirate,3700000,2956000,2956000,-744000,0.798918918918919,1948,the pirate1948
5051,she wore a yellow ribbon,1600000,5400000,5400000,3800000,3.375,1949,she wore a yellow ribbon1949
5229,sands of iwo jima,1000000,7800000,7800000,6800000,7.8,1949,sands of iwo jima1949
4775,cinderella,2900000,85000000,263591415,260691415,90.89359137931035,1950,cinderella1950
4576,annie get your gun,3768785,8000000,8000000,4231215,2.122700021359669,1950,annie get your gun1950
5020,a streetcar named desire,1800000,8000000,8000000,6200000,4.444444444444445,1951,a streetcar named desire1951
4759,alice in wonderland,3000000,0,0,-3000000,0.0,1951,alice in wonderland1951
5161,strangers on a train,1200000,7000000,7000000,5800000,5.833333333333333,1951,strangers on a train1951
5164,the day the earth stood still,1200000,3700000,3700000,2500000,3.0833333333333335,1951,the day the earth stood still1951
4860,show boat,2300000,11000000,11000000,8700000,4.782608695652174,1951,show boat1951
3858,quo vadis,8250000,30000000,30028513,21778513,3.6398197575757574,1951,quo vadis1951
4481,the greatest show on earth,4000000,36000000,36000000,32000000,9.0,1952,the greatest show on earth1952
5387,high noon,730000,8000000,8000000,7270000,10.95890410958904,1952,high noon1952
4810,singin in the rain,2540000,7200000,7200000,4660000,2.8346456692913384,1952,singin in the rain1952
5611,the beast from 20000 fathoms,210000,5000000,5000000,4790000,23.80952380952381,1953,the beast from 20000 fathoms1953
5397,house of wax,658000,23800000,23800000,23142000,36.170212765957444,1953,house of wax1953
5048,from here to eternity,1650000,30500000,30500000,28850000,18.484848484848484,1953,from here to eternity1953
5152,niagara,1250000,2500000,2500000,1250000,2.0,1953,niagara1953
4476,peter pan,4000000,87400000,87400000,83400000,21.85,1953,peter pan1953
4266,the robe,5000000,36000000,36008303,31008303,7.2016606,1953,the robe1953
5336,on the waterfront,910000,9600000,9600000,8690000,10.54945054945055,1954,on the waterfront1954
4298,the egyptian,5000000,15000000,15000000,10000000,3.0,1954,the egyptian1954
5162,the trouble with harry,1200000,7000000,7000000,5800000,5.833333333333333,1955,the trouble with harry1955
5061,the kingâs thief,1577000,0,0,-1577000,0.0,1955,the kingâs thief1955
4491,trapeze,4000000,14400000,14400000,10400000,3.6,1956,trapeze1956
4120,around the world in 80 days,6000000,42000000,42000000,36000000,7.0,1956,around the world in 80 days1956
5447,shichinin no samurai,500000,271736,271736,-228264,0.543472,1956,shichinin no samurai1956
4797,diane,2660000,0,0,-2660000,0.0,1956,diane1956
4641,carousel,3380000,0,3604,-3376396,0.0010662721893491124,1956,carousel1956
3233,the ten commandments,13500000,85400591,85434516,71934516,6.328482666666667,1956,the ten commandments1956
5168,the wrong man,1200000,2000000,2000000,800000,1.6666666666666667,1956,the wrong man1956
4141,war and peace,6000000,12500000,12524028,6524028,2.087338,1956,war and peace1956
5227,love me tender,1000000,9000000,9000000,8000000,9.0,1956,love me tender1956
4430,moby dick,4500000,10400000,10400000,5900000,2.311111111111111,1956,moby dick1956
4670,the bridge on the river kwai,3000000,33300000,33300000,30300000,11.1,1957,the bridge on the river kwai1957
5535,12 angry men,340000,0,0,-340000,0.0,1957,12 angry men1957
4315,a farewell to arms,5000000,11000000,11017403,6017403,2.2034806,1957,a farewell to arms1957
4681,cat on a hot tin roof,3000000,17570324,17570324,14570324,5.8567746666666665,1958,cat on a hot tin roof1958
4600,the nuns story,3500000,12800000,12800000,9300000,3.657142857142857,1959,the nuns story1959
3007,benhur,15000000,73000000,73259017,58259017,4.883934466666667,1959,benhur1959
4781,some like it hot,2883848,25000000,25019542,22135694,8.675749207309122,1959,some like it hot1959
4316,solomon and sheba,5000000,11000000,11014961,6014961,2.2029922,1959,solomon and sheba1959
4485,exodus,4000000,21750000,21750000,17750000,5.4375,1960,exodus1960
3409,the alamo,12000000,7900000,7900000,-4100000,0.6583333333333333,1960,the alamo1960
4691,elmer gantry,3000000,10400000,10400000,7400000,3.466666666666667,1960,elmer gantry1960
4680,the apartment,3000000,18600000,24600000,21600000,8.2,1960,the apartment1960
3373,spartacus,12000000,30000000,60000000,48000000,5.0,1960,spartacus1960
4903,the hustler,2000000,7600000,7600000,5600000,3.8,1961,the hustler1961
4503,the misfits,4000000,8200000,8200000,4200000,2.05,1961,the misfits1961
4119,west side story,6000000,43700000,43700000,37700000,7.283333333333333,1961,west side story1961
4693,judgment at nuremberg,3000000,10000000,10000000,7000000,3.3333333333333335,1961,judgment at nuremberg1961
4777,pocketful of miracles,2900000,5000000,5000000,2100000,1.7241379310344827,1961,pocketful of miracles1961
5713,the brain that wouldnt die,60000,0,0,-60000,0.0,1962,the brain that wouldnt die1962
3558,the longest day,10000000,39100000,50100000,40100000,5.01,1962,the longest day1962
3033,lawrence of arabia,15000000,37495385,69995385,54995385,4.666359,1962,lawrence of arabia1962
2743,mutiny on the bounty,19000000,13680000,13680000,-5320000,0.72,1962,mutiny on the bounty1962
4900,lolita,2000000,9250000,9250000,7250000,4.625,1962,lolita1962
4434,state fair,4500000,3500000,3500000,-1000000,0.7777777777777778,1962,state fair1962
4895,to kill a mockingbird,2000000,13129846,13129846,11129846,6.564923,1962,to kill a mockingbird1962
4654,the man who shot liberty valance,3200000,8000000,8000000,4800000,2.5,1962,the man who shot liberty valance1962
4796,donovans reef,2686000,6600000,6600000,3914000,2.4571854058078926,1963,donovans reef1963
1349,cleopatra,42000000,57000000,71000000,29000000,1.6904761904761905,1963,cleopatra1963
3759,its a mad mad mad mad world,9400000,46300000,60000000,50600000,6.382978723404255,1963,its a mad mad mad mad world1963
2898,55 days at peking,17000000,10000000,10000000,-7000000,0.5882352941176471,1963,55 days at peking1963
4495,the great escape,4000000,11744471,11972561,7972561,2.99314025,1963,the great escape1963
5212,tom jones,1000000,37600000,37600000,36600000,37.6,1963,tom jones1963
5219,dr no,1000000,16067035,59567035,58567035,59.567035,1963,dr no1963
4820,hud,2500000,10000000,10000000,7500000,4.0,1963,hud1963
2750,the fall of the roman empire,19000000,4750000,4750000,-14250000,0.25,1964,the fall of the roman empire1964
5018,dr strangelove,1800000,9164370,9230678,7430678,5.128154444444444,1964,dr strangelove1964
2870,my fair lady,17000000,72000000,72071636,55071636,4.239508,1964,my fair lady1964
4116,mary poppins,6000000,102272145,102272145,96272145,17.0453575,1964,mary poppins1964
5420,a hard days night,560000,1537860,1626784,1066784,2.9049714285714288,1964,a hard days night1964
4667,goldfinger,3000000,51100000,124900000,121900000,41.63333333333333,1964,goldfinger1964
4887,from russia with love,2000000,24800000,78900000,76900000,39.45,1964,from russia with love1964
2617,the greatest story ever told,20000000,15473333,15473333,-4526667,0.77366665,1965,the greatest story ever told1965
4573,major dundee,3800000,14873,14873,-3785127,0.003913947368421052,1965,major dundee1965
3466,doctor zhivago,11000000,111897830,112036323,101036323,10.185120272727273,1965,doctor zhivago1965
3859,the sound of music,8200000,163214286,286214286,278014286,34.904181219512196,1965,the sound of music1965
3771,thunderball,9000000,63600000,141200000,132200000,15.688888888888888,1965,thunderball1965
4199,the train,5800000,6800000,6800000,1000000,1.1724137931034482,1965,the train1965
3037,hawaii,15000000,34562222,34562222,19562222,2.3041481333333333,1966,hawaii1966
4687,torn curtain,3000000,13000000,13000000,10000000,4.333333333333333,1966,torn curtain1966
5128,batman  the movie,1377800,0,0,-1377800,0.0,1966,batman  the movie1966
4568,a man for all seasons,3900000,28350000,28350000,24450000,7.269230769230769,1966,a man for all seasons1966
4602,harper,3500000,12000000,12000000,8500000,3.4285714285714284,1966,harper1966
4993,a funny thing happened on the way to the forum,2000000,0,0,-2000000,0.0,1966,a funny thing happened on the way to the forum1966
4768,point blank,3000000,0,0,-3000000,0.0,1967,point blank1967
5409,per qualche dollaro in piã¹,600000,4300000,4300000,3700000,7.166666666666667,1967,per qualche dollaro in piã¹1967
3753,you only live twice,9500000,43100000,111600000,102100000,11.74736842105263,1967,you only live twice1967
4599,in cold blood,3500000,13000000,13007551,9507551,3.716443142857143,1967,in cold blood1967
5616,per un pugno di dollari,200000,3500000,3516248,3316248,17.58124,1967,per un pugno di dollari1967
5163,il buono il brutto il cattivo,1200000,6100000,6100000,4900000,5.083333333333333,1967,il buono il brutto il cattivo1967
4890,in the heat of the night,2000000,24379978,24407647,22407647,12.2038235,1967,in the heat of the night1967
3381,casino royale,12000000,22744718,41744718,29744718,3.4787265,1967,casino royale1967
3821,barbarella,9000000,0,0,-9000000,0.0,1968,barbarella1968
5118,shalako,1455000,2620000,2620000,1165000,1.8006872852233677,1968,shalako1968
4652,rosemarys baby,3200000,33395426,33395426,30195426,10.436070625,1968,rosemarys baby1968
5386,la mariãe ãtait en noir,747000,44566,44566,-702434,0.05965997322623828,1968,la mariãe ãtait en noir1968
4198,planet of the apes,5800000,33395426,33395426,27595426,5.757832068965517,1968,planet of the apes1968
5676,night of the living dead,114000,12087064,30087064,29973064,263.9216140350877,1968,night of the living dead1968
3563,oliver,10000000,37402877,37402877,27402877,3.7402877,1968,oliver1968
3526,2001 a space odyssey,10500000,59936321,71928046,61428046,6.850290095238095,1968,2001 a space odyssey1968
5021,hang em high,1800000,6800000,6800000,5000000,3.7777777777777777,1968,hang em high1968
2344,hello dolly,24000000,33208099,33208099,9208099,1.3836707916666666,1969,hello dolly1969
4174,the wild bunch,6000000,509424,509424,-5490576,0.084904,1969,the wild bunch1969
5612,the stewardesses,200000,13500000,25000000,24800000,125.0,1969,the stewardesses1969
4584,midnight cowboy,3600000,44785053,44785053,41185053,12.4402925,1969,midnight cowboy1969
2658,sweet charity,20000000,8000000,8000000,-12000000,0.4,1969,sweet charity1969
4509,topaz,4000000,6000000,6000000,2000000,1.5,1969,topaz1969
4115,butch cassidy and the sundance kid,6000000,102308900,102310653,96310653,17.0517755,1969,butch cassidy and the sundance kid1969
4333,once upon a time in the west,5000000,5321508,5378425,378425,1.075685,1969,once upon a time in the west1969
2563,paint your wagon,20000000,31678778,31678778,11678778,1.5839389,1969,paint your wagon1969
3880,on her majestys secret service,8000000,22800000,82000000,74000000,10.25,1969,on her majestys secret service1969
4580,the ballad of cable hogue,3716946,3500000,5000000,1283054,1.3451903794136368,1970,the ballad of cable hogue1970
3506,the molly maguires,11000000,2200000,2200000,-8800000,0.2,1970,the molly maguires1970
4588,mash,3500000,81600000,81600000,78100000,23.314285714285713,1970,mash1970
2233,tora tora tora,25000000,29548291,29548291,4548291,1.18193164,1970,tora tora tora1970
5407,woodstock,600000,34505110,34505110,33905110,57.508516666666665,1970,woodstock1970
4682,beneath the planet of the apes,3000000,17489009,17489009,14489009,5.829669666666667,1970,beneath the planet of the apes1970
5226,beyond the valley of the dolls,1000000,9000000,9000000,8000000,9.0,1970,beyond the valley of the dolls1970
2798,catch22,18000000,24911670,24911670,6911670,1.3839816666666667,1970,catch221970
2445,darling lili,22000000,5000000,5000000,-17000000,0.22727272727272727,1970,darling lili1970
3356,patton,12000000,62500000,62500000,50500000,5.208333333333333,1970,patton1970
2327,waterloo,25000000,0,0,-25000000,0.0,1970,waterloo1970
4819,escape from the planet of the apes,2500000,12300000,12300000,9800000,4.92,1971,escape from the planet of the apes1971
4980,bananas,2000000,0,0,-2000000,0.0,1971,bananas1971
5357,billy jack,800000,98000000,98000000,97200000,122.5,1971,billy jack1971
4870,the french connection,2200000,41158757,41158757,38958757,18.70852590909091,1971,the french connection1971
4715,willy wonka  the chocolate factory,3000000,4000000,4000000,1000000,1.3333333333333333,1971,willy wonka  the chocolate factory1971
4092,the andromeda strain,6500000,12376563,12376563,5876563,1.9040866153846154,1971,the andromeda strain1971
3982,diamonds are forever,7200000,43800000,116000000,108800000,16.11111111111111,1971,diamonds are forever1971
5655,sweet sweetbacks baad asssss song,150000,15200000,15200000,15050000,101.33333333333333,1971,sweet sweetbacks baad asssss song1971
3769,fiddler on the roof,9000000,80500000,80500000,71500000,8.944444444444445,1971,fiddler on the roof1971
4892,everything you always wanted to know,2000000,18016290,18016290,16016290,9.008145,1972,everything you always wanted to know1972
3986,the godfather,7000000,134966411,268500000,261500000,38.357142857142854,1972,the godfather1972
4601,frenzy,3500000,12600000,12600000,9100000,3.6,1972,frenzy1972
5040,conquest of the planet of the apes,1700000,9700000,9700000,8000000,5.705882352941177,1972,conquest of the planet of the apes1972
5699,the last house on the left,87000,3100000,3100000,3013000,35.632183908045974,1972,the last house on the left1972
5745,deep throat,25000,45000000,45000000,44975000,1800.0,1972,deep throat1972
4558,1776,4000000,0,0,-4000000,0.0,1972,17761972
4218,high plains drifter,5500000,15700000,15700000,10200000,2.8545454545454545,1973,high plains drifter1973
5372,american graffiti,777000,115000000,140000000,139223000,180.18018018018017,1973,american graffiti1973
4891,sleeper,2000000,18344729,18344729,16344729,9.1723645,1973,sleeper1973
5019,battle for the planet of the apes,1800000,8800000,8800000,7000000,4.888888888888889,1973,battle for the planet of the apes1973
4415,pat garrett and billy the kid,4638783,8000000,11000000,6361217,2.3713116134123973,1973,pat garrett and billy the kid1973
4213,the sting,5500000,159616327,159616327,154116327,29.021150363636362,1973,the sting1973
3993,live and let die,7000000,35400000,161800000,154800000,23.114285714285714,1973,live and let die1973
3341,the exorcist,12000000,230347346,428214478,416214478,35.68453983333333,1973,the exorcist1973
5052,the conversation,1600000,4420000,4420000,2820000,2.7625,1974,the conversation1974
4783,young frankenstein,2800000,86300000,86300000,83500000,30.821428571428573,1974,young frankenstein1974
3174,towering inferno,14000000,116000000,139700000,125700000,9.978571428571428,1974,towering inferno1974
5429,benji,500000,31559560,31559560,31059560,63.11912,1974,benji1974
5665,the texas chainsaw massacre,140000,26572439,26572439,26432439,189.8031357142857,1974,the texas chainsaw massacre1974
4490,the front page,4000000,15000000,15000000,11000000,3.75,1974,the front page1974
3252,the godfather part ii,13000000,57300000,57300000,44300000,4.407692307692308,1974,the godfather part ii1974
4575,the taking of pelham one two three,3800000,0,0,-3800000,0.0,1974,the taking of pelham one two three1974
4800,blazing saddles,2600000,119500000,119500000,116900000,45.96153846153846,1974,blazing saddles1974
3999,the great gatsby,7000000,26533200,26533200,19533200,3.790457142857143,1974,the great gatsby1974
4006,the man with the golden gun,7000000,21000000,97600000,90600000,13.942857142857143,1974,the man with the golden gun1974
4264,the return of the pink panther,5000000,41833347,41833347,36833347,8.3666694,1975,the return of the pink panther1975
5508,monty python and the holy grail,400000,3427696,5028948,4628948,12.57237,1975,monty python and the holy grail1975
5559,death race 2000,300000,0,0,-300000,0.0,1975,death race 20001975
5169,the rocky horror picture show,1200000,1414845,1615976,415976,1.3466466666666668,1975,the rocky horror picture show1975
4677,love and death,3000000,20123742,20123742,17123742,6.707914,1975,love and death1975
3340,jaws,12000000,260000000,470700000,458700000,39.225,1975,jaws1975
3488,barry lyndon,11000000,20000000,20169934,9169934,1.8336303636363636,1975,barry lyndon1975
4459,one flew over the cuckoos nest,4400000,108981275,108997629,104597629,24.77218840909091,1975,one flew over the cuckoos nest1975
4686,family plot,3000000,13200000,13200000,10200000,4.4,1976,family plot1976
5015,carrie,1800000,25878153,25878153,24078153,14.376751666666667,1976,carrie1976
4570,network,3800000,23689877,23689877,19889877,6.234178157894737,1976,network1976
4784,the omen,2800000,48570885,48570885,45770885,17.346744642857143,1976,the omen1976
4460,silent movie,4400000,36145695,36145695,31745695,8.214930681818181,1976,silent movie1976
4325,robin and marian,5000000,8000000,8000000,3000000,1.6,1976,robin and marian1976
4002,logans run,7000000,25000000,25000000,18000000,3.5714285714285716,1976,logans run1976
5210,rocky,1000000,117235147,225000000,224000000,225.0,1976,rocky1976
5214,taxi driver,1000000,28262574,28316211,27316211,28.316211,1976,taxi driver1976
5170,the blue bird,1200000,887000,887000,-313000,0.7391666666666666,1976,the blue bird1976
4635,high anxiety,3400000,31063038,31063038,27663038,9.136187647058824,1977,high anxiety1977
3182,the spy who loved me,14000000,46800000,185400000,171400000,13.242857142857142,1977,the spy who loved me1977
4048,march or die,7000000,1000000,1000000,-6000000,0.14285714285714285,1977,march or die1977
3193,exorcist ii the heretic,14000000,25011000,25011000,11011000,1.7865,1977,exorcist ii the heretic1977
2452,sorcerer,21600000,12000000,12005968,-9594032,0.5558318518518518,1977,sorcerer1977
4479,annie hall,4000000,38251425,38251425,34251425,9.56285625,1977,annie hall1977
3566,peteâs dragon,10000000,36000000,36000000,26000000,3.6,1977,peteâs dragon1977
2914,damnation alley,17000000,0,0,-17000000,0.0,1977,damnation alley1977
2131,a bridge too far,26000000,50800000,50800000,24800000,1.9538461538461538,1977,a bridge too far1977
3202,new york new york,14000000,13800000,13800000,-200000,0.9857142857142858,1977,new york new york1977
5431,kingdom of the spiders,500000,17000000,17000000,16500000,34.0,1977,kingdom of the spiders1977
5408,the kentucky fried movie,600000,15000000,20000000,19400000,33.333333333333336,1977,the kentucky fried movie1977
2489,close encounters of the third kind,20000000,169100479,340800479,320800479,17.04002395,1977,close encounters of the third kind1977
3464,star wars ep iv a new hope,11000000,460998007,786598007,775598007,71.50890972727272,1977,star wars ep iv a new hope1977
5681,eraserhead,100000,7000000,7014590,6914590,70.1459,1977,eraserhead1977
988,superman,55000000,134218018,300200000,245200000,5.458181818181818,1978,superman1978
4112,grease,6000000,181813770,387510179,381510179,64.58502983333334,1978,grease1978
3222,caravans,14000000,1000000,1000000,-13000000,0.07142857142857142,1978,caravans1978
3003,heaven can wait,15000000,98800000,98800000,83800000,6.586666666666667,1978,heaven can wait1978
2353,the wiz,24000000,22000000,22000000,-2000000,0.9166666666666666,1978,the wiz1978
3487,fist,11000000,20388920,20388920,9388920,1.8535381818181818,1978,fist1978
4326,force 10 from navarone,5000000,7100000,7100000,2100000,1.42,1978,force 10 from navarone1978
5536,halloween,325000,47000000,70000000,69675000,215.3846153846154,1978,halloween1978
4663,national lampoons animal house,3000000,141600000,141600000,138600000,47.2,1978,national lampoons animal house1978
4671,coming home,3000000,32653000,32653000,29653000,10.884333333333334,1978,coming home1978
4718,days of heaven,3000000,3446749,3660880,660880,1.2202933333333332,1978,days of heaven1978
3387,the boys from brazil,12000000,19000000,19000000,7000000,1.5833333333333333,1978,the boys from brazil1978
2500,jaws 2,20000000,102922376,208900376,188900376,10.4450188,1978,jaws 21978
2549,the black hole,20000000,35841901,35841901,15841901,1.79209505,1979,the black hole1979
1803,1941,32000000,34175000,94875000,62875000,2.96484375,1979,19411979
5651,dolphin,170000,14000,14000,-156000,0.08235294117647059,1979,dolphin1979
4176,the first great train robbery,6000000,391942,391942,-5608058,0.06532366666666667,1979,the first great train robbery1979
3019,the deer hunter,15000000,50000000,50009253,35009253,3.3339502,1979,the deer hunter1979
3382,prophecy,12000000,22673340,22673340,10673340,1.889445,1979,prophecy1979
1825,moonraker,31000000,70300000,210300000,179300000,6.783870967741936,1979,moonraker1979
3326,the prisoner of zenda,12500000,7000000,7000000,-5500000,0.56,1979,the prisoner of zenda1979
1819,apocalypse now,31500000,78800000,81250485,49750485,2.5793804761904764,1979,apocalypse now1979
3869,escape from alcatraz,8000000,43000000,43000000,35000000,5.375,1979,escape from alcatraz1979
3836,the rose,8500000,29200000,29200000,20700000,3.4352941176470586,1979,the rose1979
4790,the black stallion,2700000,37799643,37799643,35099643,13.999867777777778,1979,the black stallion1979
2962,meteor,16000000,8400000,8400000,-7600000,0.525,1979,meteor1979
3520,alien,10700000,80930630,203628947,192928947,19.030742710280375,1979,alien1979
1637,star trek the motion picture,35000000,82258456,139000000,104000000,3.9714285714285715,1979,star trek the motion picture1979
4487,life of brian,4000000,20182359,20468305,16468305,5.11707625,1979,life of brian1979
5074,dawn of the dead,1500000,5100000,55000000,53500000,36.666666666666664,1979,dawn of the dead1979
3863,the muppet movie,8000000,76657000,76657000,68657000,9.582125,1979,the muppet movie1979
2094,the blues brothers,27000000,57229890,57229890,30229890,2.1196255555555554,1980,the blues brothers1980
1519,raise the titanic,40000000,7000000,7000000,-33000000,0.175,1980,raise the titanic1980
5686,penitentiary,100000,287000,287000,187000,2.87,1980,penitentiary1980
5515,home movies,400000,89134,89134,-310866,0.222835,1980,home movies1980
1749,lion of the desert,35000000,1500000,1500000,-33500000,0.04285714285714286,1980,lion of the desert1980
4425,the blue lagoon,4500000,47923795,47923795,43423795,10.649732222222223,1980,the blue lagoon1980
3009,private benjamin,15000000,69847348,69847348,54847348,4.656489866666667,1980,private benjamin1980
3618,the long riders,10000000,15198912,15198912,5198912,1.5198912,1980,the long riders1980
1696,flash gordon,35000000,27107960,27107960,-7892040,0.7745131428571429,1980,flash gordon1980
2367,star wars ep v the empire strikes back,23000000,290271960,534161334,511161334,23.224405826086958,1980,star wars ep v the empire strikes back1980
5527,maniac,350000,10000000,10000000,9650000,28.571428571428573,1980,maniac1980
2685,cant stop the music,20000000,2000000,2000000,-18000000,0.1,1980,cant stop the music1980
4605,terror train,3500000,8000000,8000000,4500000,2.2857142857142856,1980,terror train1980
2434,the island,22000000,15716828,15716828,-6283172,0.7144012727272727,1980,the island1980
5192,the fog,1100000,21445318,21445820,20345820,19.4962,1980,the fog1980
4121,caddyshack,6000000,39846344,39846344,33846344,6.641057333333333,1980,caddyshack1980
5424,friday the 13th,550000,39754601,59754601,59204601,108.6447290909091,1980,friday the 13th1980
4088,dressed to kill,6500000,31899000,31899000,25399000,4.907538461538461,1980,dressed to kill1980
4246,somewhere in time,5100000,9709597,9709597,4609597,1.9038425490196078,1980,somewhere in time1980
1333,heavens gate,44000000,3484331,3484523,-40515477,0.07919370454545455,1980,heavens gate1980
4587,airplane,3500000,83453539,83453539,79953539,23.843868285714287,1980,airplane1980
5613,mad max,200000,8750000,99750000,99550000,498.75,1980,mad max1980
4274,the elephant man,5000000,26010864,26010864,21010864,5.2021728,1980,the elephant man1980
2525,popeye,20000000,49823037,49823037,29823037,2.49115185,1980,popeye1980
2800,raging bull,18000000,23380203,23380203,5380203,1.2989001666666666,1980,raging bull1980
4117,ordinary people,6000000,52302978,52302978,46302978,8.717163,1980,ordinary people1980
3010,coal miners daughter,15000000,67182787,67182787,52182787,4.478852466666667,1980,coal miners daughter1980
2732,the shining,19000000,44017374,44728227,25728227,2.354117210526316,1980,the shining1980
4223,galaxina,5500000,4865000,4865000,-635000,0.8845454545454545,1980,galaxina1980
1048,superman ii,54000000,108185706,108185706,54185706,2.003439,1981,superman ii1981
3657,heartbeeps,10000000,6000000,6000000,-4000000,0.6,1981,heartbeeps1981
2907,roar,17000000,2110050,2110050,-14889950,0.12412058823529412,1981,roar1981
4087,the four seasons,6500000,42488161,42488161,35988161,6.536640153846154,1981,the four seasons1981
4214,chariots of fire,5500000,61558162,61865947,56365947,11.248354,1981,chariots of fire1981
3050,clash of the titans,15000000,30000000,44400000,29400000,2.96,1981,clash of the titans1981
5568,graduation day,250000,23894000,23894000,23644000,95.576,1981,graduation day1981
5147,friday the 13th part 2,1250000,21722776,21722776,20472776,17.3782208,1981,friday the 13th part 21981
5218,the howling,1000000,17985000,17985000,16985000,17.985,1981,the howling1981
3539,stripes,10000000,85300000,85300000,75300000,8.53,1981,stripes1981
2825,dragonslayer,18000000,6000000,6000000,-12000000,0.3333333333333333,1981,dragonslayer1981
4706,gallipoli,3000000,5732587,5732587,2732587,1.9108623333333334,1981,gallipoli1981
4290,mommie dearest,5000000,19032000,25032000,20032000,5.0064,1981,mommie dearest1981
3679,sphinx,10000000,2000000,11400000,1400000,1.14,1981,sphinx1981
4300,nighthawks,5000000,14600000,19600000,14600000,3.92,1981,nighthawks1981
2817,the legend of the lone ranger,18000000,13400000,13400000,-4600000,0.7444444444444445,1981,the legend of the lone ranger1981
2486,raiders of the lost ark,20000000,225686079,367452079,347452079,18.37260395,1981,raiders of the lost ark1981
1768,reds,33500000,50000000,50000000,16500000,1.492537313432836,1981,reds1981
2048,for your eyes only,28000000,54800000,195300000,167300000,6.975,1981,for your eyes only1981
4816,halloween ii,2500000,25533818,25533818,23033818,10.2135272,1981,halloween ii1981
3879,modern problems,8000000,24474312,24474312,16474312,3.059289,1981,modern problems1981
3365,time bandits,12000000,37400000,37400000,25400000,3.1166666666666667,1981,time bandits1981
4125,escape from new york,6000000,25244700,25245925,19245925,4.207654166666667,1981,escape from new york1981
3481,history of the world part i,11000000,31672000,31672000,20672000,2.879272727272727,1981,history of the world part i1981
2598,under the rainbow,20000000,18826490,18826490,-1173510,0.9413245,1981,under the rainbow1981
3762,heavy metal,9300000,19571091,19571091,10271091,2.104418387096774,1981,heavy metal1981
2815,blow out,18000000,13747234,13747234,-4252766,0.7637352222222222,1981,blow out1981
3184,taps,14000000,35856053,35856053,21856053,2.561146642857143,1981,taps1981
3400,the postman always rings twice,12000000,12200000,44200000,32200000,3.683333333333333,1981,the postman always rings twice1981
3425,the pursuit of db cooper,12000000,2104164,2104164,-9895836,0.175347,1981,the pursuit of db cooper1981
2483,the best little whorehouse in texas,20500000,69701637,69701637,49201637,3.4000798536585366,1982,the best little whorehouse in texas1982
2888,tron,17000000,26918576,26918576,9918576,1.5834456470588236,1982,tron1982
4475,porkys,4000000,109492484,109492484,105492484,27.373121,1982,porkys1982
4343,jekyll and hyde together again,5000000,3707583,3707583,-1292417,0.7415166,1982,jekyll and hyde together again1982
3883,creepshow,8000000,20036244,20036244,12036244,2.5045305,1982,creepshow1982
4286,the man from snowy river,5000000,20659423,20659423,15659423,4.1318846,1982,the man from snowy river1982
4317,the beastmaster,5000000,10751126,10751126,5751126,2.1502252,1982,the beastmaster1982
4888,mad max 2 the road warrior,2000000,24600832,24600832,22600832,12.300416,1982,mad max 2 the road warrior1982
3347,star trek ii the wrath of khan,12000000,78912963,95800000,83800000,7.983333333333333,1982,star trek ii the wrath of khan1982
2994,tootsie,15000000,177200000,177200000,162200000,11.813333333333333,1982,tootsie1982
2061,blade runner,28000000,32656328,39342912,11342912,1.405104,1982,blade runner1982
2413,gandhi,22000000,52767889,127767889,105767889,5.807631318181818,1982,gandhi1982
3319,la guerre du feu,12500000,20959585,20959585,8459585,1.6767668,1982,la guerre du feu1982
4426,fast times at ridgemont high,4500000,27092880,27092880,22592880,6.02064,1982,fast times at ridgemont high1982
3525,et the extraterrestrial,10500000,435110554,792965326,782465326,75.52050723809523,1982,et the extraterrestrial1982
5173,q,1200000,255000,255000,-945000,0.2125,1982,q1982
3521,poltergeist,10700000,74706019,121706019,111006019,11.37439429906542,1982,poltergeist1982
3237,the border,13500000,6118683,6118683,-7381317,0.4532357777777778,1982,the border1982
3402,das boot,12000000,11487676,84970337,72970337,7.080861416666667,1982,das boot1982
4869,friday the 13th part 3,2250000,36690067,36690067,34440067,16.306696444444444,1982,friday the 13th part 31982
1249,inchon,46000000,4408636,4408636,-41591364,0.09583991304347826,1982,inchon1982
2462,firefox,21000000,45785720,45785720,24785720,2.1802723809523807,1982,firefox1982
4817,halloween 3 season of the witch,2500000,14400000,14400000,11900000,5.76,1982,halloween 3 season of the witch1982
3181,first blood,14000000,47212904,125212904,111212904,8.943778857142858,1982,first blood1982
2829,megaforce,18000000,5675599,5675599,-12324401,0.31531105555555555,1982,megaforce1982
2930,the verdict,16000000,53977250,53977250,37977250,3.373578125,1982,the verdict1982
4310,diner,5000000,12592907,12592907,7592907,2.5185814,1982,diner1982
4649,class of 1984,3250000,6965361,6965361,3715361,2.143188,1982,class of 19841982
2543,conan the barbarian,20000000,38264085,79114085,59114085,3.95570425,1982,conan the barbarian1982
5130,the ballad of gregorio cortez,1305000,909000,909000,-396000,0.696551724137931,1983,the ballad of gregorio cortez1983
3918,the wicked lady,8000000,589308,589308,-7410692,0.0736635,1983,the wicked lady1983
5525,the evil dead,375000,2400000,29400000,29025000,78.4,1983,the evil dead1983
1783,star wars ep vi return of the jedi,32500000,309205079,572705079,540205079,17.62169473846154,1983,star wars ep vi return of the jedi1983
3988,flashdance,7000000,90463574,201463574,194463574,28.78051057142857,1983,flashdance1983
3585,twilight zone the movie,10000000,29500000,29500000,19500000,2.95,1983,twilight zone the movie1983
1608,never say never again,36000000,55500000,160000000,124000000,4.444444444444445,1983,never say never again1983
3532,lovesick,10100000,10143618,10143618,43618,1.0043186138613862,1983,lovesick1983
3601,the dead zone,10000000,20766000,20766000,10766000,2.0766,1983,the dead zone1983
4008,breathless,7000000,19910002,19910002,12910002,2.844286,1983,breathless1983
3593,the outsiders,10000000,25697647,25697647,15697647,2.5697647,1983,the outsiders1983
3349,wargames,12000000,74433837,74433837,62433837,6.20281975,1983,wargames1983
4046,losin it,7000000,1246141,1246141,-5753859,0.17802014285714285,1983,losin it1983
5514,e tu vivrai nel terrore  laldilã,400000,126387,126387,-273613,0.3159675,1983,e tu vivrai nel terrore  laldilã1983
2202,scarface,25000000,44942821,44942821,19942821,1.79771284,1983,scarface1983
4648,a christmas story,3250000,20605209,20605209,17355209,6.340064307692308,1983,a christmas story1983
3104,brainstorm,15000000,8921050,8921050,-6078950,0.5947366666666667,1983,brainstorm1983
2102,the right stuff,27000000,21500000,21500000,-5500000,0.7962962962962963,1983,the right stuff1983
1545,superman iii,39000000,59950623,59950623,20950623,1.5371954615384615,1983,superman iii1983
4195,videodrome,5952000,2120439,2120439,-3831561,0.35625655241935483,1983,videodrome1983
2082,octopussy,27500000,67900000,187500000,160000000,6.818181818181818,1983,octopussy1983
4312,lone wolf mcquade,5000000,12232628,12232628,7232628,2.4465256,1983,lone wolf mcquade1983
3013,national lampoonâs vacation,15000000,61400000,61400000,46400000,4.093333333333334,1983,national lampoonâs vacation1983
3362,yentl,12000000,39012241,39012241,27012241,3.251020083333333,1983,yentl1983
2796,conan the destroyer,18000000,26400000,26400000,8400000,1.4666666666666666,1984,conan the destroyer1984
5491,the toxic avenger,475000,0,0,-475000,0.0,1984,the toxic avenger1984
5425,love letters,550000,5269990,5269990,4719990,9.5818,1984,love letters1984
3787,the ice pirates,9000000,13075390,13075390,4075390,1.4528211111111111,1984,the ice pirates1984
1988,once upon a time in america,30000000,5321508,5575648,-24424352,0.18585493333333333,1984,once upon a time in america1984
2769,star trek iii the search for spock,18000000,76471046,87000000,69000000,4.833333333333333,1984,star trek iii the search for spock1984
4104,the terminator,6400000,38019031,78019031,71619031,12.19047359375,1984,the terminator1984
5079,repo man,1500000,2300000,2300000,800000,1.5333333333333334,1984,repo man1984
4801,friday the 13th part iv the final chapter,2600000,32980880,32980880,30380880,12.684953846153846,1984,friday the 13th part iv the final chapter1984
2297,sheena,25000000,5778353,5778353,-19221647,0.23113412,1984,sheena1984
3864,splash,8000000,62599495,62599495,54599495,7.824936875,1984,splash1984
2103,die unendliche geschichte,27000000,21300000,21392049,-5607951,0.7922981111111111,1984,die unendliche geschichte1984
2033,indiana jones and the temple of doom,28000000,179880271,333080271,305080271,11.895723964285715,1984,indiana jones and the temple of doom1984
3640,body double,10000000,8801940,8801940,-1198060,0.880194,1984,body double1984
4423,police academy,4500000,81198894,81198894,76698894,18.044198666666666,1984,police academy1984
2780,amadeus,18000000,51973029,51973029,33973029,2.8873905,1984,amadeus1984
1297,dune,45000000,27447471,27447471,-17552529,0.6099438,1984,dune1984
1229,the cotton club,48000000,25928721,25928721,-22071279,0.5401816875,1984,the cotton club1984
5016,a nightmare on elm street,1800000,25504513,25504513,23704513,14.169173888888889,1984,a nightmare on elm street1984
3962,the hotel new hampshire,7500000,5142858,5142858,-2357142,0.6857144,1984,the hotel new hampshire1984
1835,ghostbusters,30000000,242212467,295212467,265212467,9.840415566666668,1984,ghostbusters1984
3465,gremlins,11000000,148168459,148199515,137199515,13.472683181818182,1984,gremlins1984
3079,firestarter,15000000,15136870,15136870,136870,1.0091246666666667,1984,firestarter1984
2992,beverly hills cop,15000000,234760478,316300000,301300000,21.086666666666666,1984,beverly hills cop1984
2086,a passage to india,27500000,27187653,27187653,-312347,0.9886419272727273,1984,a passage to india1984
3860,footloose,8200000,80000000,80000000,71800000,9.75609756097561,1984,footloose1984
3862,the karate kid,8000000,90815558,90815558,82815558,11.35194475,1984,the karate kid1984
5149,chud,1250000,4700000,4700000,3450000,3.76,1984,chud1984
3609,invasion usa,10000000,17536256,17536256,7536256,1.7536256,1985,invasion usa1985
5081,blood simple,1500000,1690913,2730877,1230877,1.8205846666666667,1985,blood simple1985
3352,witness,12000000,65532576,65532576,53532576,5.461048,1985,witness1985
3573,the last dragon,10000000,33000000,33000000,23000000,3.3,1985,the last dragon1985
4675,a nightmare on elm street part 2 freddys revenge,3000000,21163999,21163999,18163999,7.0546663333333335,1985,a nightmare on elm street part 2 freddys revenge1985
4492,the return of the living dead,4000000,14237880,14237880,10237880,3.55947,1985,the return of the living dead1985
4690,krush groove,3000000,11052713,11052713,8052713,3.6842376666666667,1985,krush groove1985
2108,return to oz,27000000,10618813,10618813,-16381187,0.3932893703703704,1985,return to oz1985
1897,a view to a kill,30000000,50327960,152627960,122627960,5.087598666666667,1985,a view to a kill1985
3565,mad max beyond thunderdome,10000000,36230219,36230219,26230219,3.6230219,1985,mad max beyond thunderdome1985
2804,young sherlock holmes,18000000,19739000,19739000,1739000,1.0966111111111112,1985,young sherlock holmes1985
3568,commando,10000000,35073978,35073978,25073978,3.5073978,1985,commando1985
2599,ladyhawke,20000000,18400000,18400000,-1600000,0.92,1985,ladyhawke1985
1328,rambo first blood part ii,44000000,150415432,300400000,256400000,6.827272727272727,1985,rambo first blood part ii1985
2854,red sonja,17900000,6905861,6908640,-10991360,0.3859575418994413,1985,red sonja1985
1824,out of africa,31000000,79096868,258210860,227210860,8.329382580645161,1985,out of africa1985
4609,day of the dead,3500000,5804262,34004262,30504262,9.715503428571429,1985,day of the dead1985
3099,brazil,15000000,9929135,9932146,-5067854,0.6621430666666667,1985,brazil1985
4945,subway,2000000,390659,1663296,-336704,0.831648,1985,subway1985
3562,st elmoâs fire,10000000,37800000,37800000,27800000,3.78,1985,st elmoâs fire1985
4429,after hours,4500000,10609321,10609321,6109321,2.357626888888889,1985,after hours1985
2278,lifeforce,25000000,11603545,11603545,-13396455,0.4641418,1985,lifeforce1985
4871,friday the 13th part v a new beginning,2200000,21930418,21930418,19730418,9.968371818181819,1985,friday the 13th part v a new beginning1985
4019,silver bullet,7000000,10803211,10803211,3803211,1.5433158571428571,1985,silver bullet1985
5138,defcon 4,1300000,210904,210904,-1089096,0.16223384615384615,1985,defcon 41985
2139,silverado,26000000,33200000,33200000,7200000,1.2769230769230768,1985,silverado1985
2723,back to the future,19000000,212259762,385524784,366524784,20.290778105263158,1985,back to the future1985
4071,pale rider,6900000,41410568,41410568,34510568,6.001531594202898,1985,pale rider1985
3004,the color purple,15000000,93589701,93589701,78589701,6.2393134,1985,the color purple1985
2841,8 million ways to die,18000000,1305114,1305114,-16694886,0.07250633333333334,1986,8 million ways to die1986
4437,salvador,4500000,1500000,1500000,-3000000,0.3333333333333333,1986,salvador1986
1916,little shop of horrors,30000000,38747385,38747385,8747385,1.2915795,1986,little shop of horrors1986
4309,april fools day,5000000,12947763,12947763,7947763,2.5895526,1986,april fools day1986
2196,cobra,25000000,49042224,49042224,24042224,1.96168896,1986,cobra1986
5646,shes gotta have it,175000,7137502,7137502,6962502,40.78572571428571,1986,shes gotta have it1986
2262,legend,25000000,15502112,23506237,-1493763,0.94024948,1986,legend1986
4035,american anthem,7000000,3571624,3571624,-3428376,0.510232,1986,american anthem1986
4113,platoon,6000000,137963328,137978395,131978395,22.996399166666667,1986,platoon1986
2867,aliens,17000000,85160248,183316455,166316455,10.78332088235294,1986,aliens1986
1965,howard the duck,30000000,16295774,16295774,-13704226,0.5431924666666667,1986,howard the duck1986
2282,big trouble in little china,25000000,11100000,11100000,-13900000,0.444,1986,big trouble in little china1986
3133,the clan of the cave bear,15000000,1953732,1953732,-13046268,0.1302488,1986,the clan of the cave bear1986
4676,a room with a view,3000000,20966644,20966644,17966644,6.9888813333333335,1986,a room with a view1986
2786,peggy sue got married,18000000,41382841,41382841,23382841,2.299046722222222,1986,peggy sue got married1986
4678,friday the 13th part vi jason lives,3000000,19472057,19472057,16472057,6.490685666666667,1986,friday the 13th part vi jason lives1986
2823,nine 12 weeks,18000000,6734844,6734844,-11265156,0.374158,1986,nine 12 weeks1986
4904,witchboard,2000000,7369373,7369373,5369373,3.6846865,1986,witchboard1986
3826,crocodile dundee,8800000,174803506,328203506,319403506,37.29585295454545,1986,crocodile dundee1986
4410,the texas chainsaw massacre 2,4700000,8025872,8025872,3325872,1.707632340425532,1986,the texas chainsaw massacre 21986
5520,my beautiful laundrette,400000,0,0,-400000,0.0,1986,my beautiful laundrette1986
1748,playing for keeps,35000000,2000000,2000000,-33000000,0.05714285714285714,1986,playing for keeps1986
3549,the color of money,10000000,52293000,52293000,42293000,5.2293,1986,the color of money1986
2331,star trek iv the voyage home,24000000,109713132,133000000,109000000,5.541666666666667,1986,star trek iv the voyage home1986
2905,shanghai surprise,17000000,2315000,2315000,-14685000,0.1361764705882353,1986,shanghai surprise1986
5196,down by law,1100000,1436000,1436000,336000,1.3054545454545454,1986,down by law1986
3867,stand by me,8000000,52287414,52287414,44287414,6.53592675,1986,stand by me1986
3346,the golden child,12000000,79817937,79817937,67817937,6.65149475,1986,the golden child1986
2963,highlander,16000000,5900000,12900000,-3100000,0.80625,1986,highlander1986
3417,invaders from mars,12000000,4884663,4984663,-7015337,0.41538858333333334,1986,invaders from mars1986
2993,top gun,15000000,179800601,356799634,341799634,23.786642266666668,1986,top gun1986
1530,pirates,40000000,1641825,6341825,-33658175,0.158545625,1986,pirates1986
1439,legal eagles,40000000,49851591,49851591,9851591,1.246289775,1986,legal eagles1986
4608,evil dead ii,3500000,5923044,5926177,2426177,1.6931934285714285,1987,evil dead ii1987
2490,beverly hills cop ii,20000000,153665036,276665036,256665036,13.8332518,1987,beverly hills cop ii1987
4086,la bamba,6500000,54215416,54215416,47715416,8.340833230769231,1987,la bamba1987
2204,the last emperor,25000000,43984987,44005073,19005073,1.76020292,1987,the last emperor1987
5220,hellraiser,1000000,14564000,14575148,13575148,14.575148,1987,hellraiser1987
4699,teen wolf too,3000000,7888000,7888000,4888000,2.6293333333333333,1987,teen wolf too1987
3254,robocop,13000000,53424681,53424681,40424681,4.109590846153846,1987,robocop1987
2897,superman iv the quest for peace,17000000,11227824,11227824,-5772176,0.6604602352941177,1987,superman iv the quest for peace1987
4260,a nightmare on elm street 3 dream warriors,5000000,44793222,44793222,39793222,8.9586444,1987,a nightmare on elm street 3 dream warriors1987
5682,hollywood shuffle,100000,5228617,5228617,5128617,52.28617,1987,hollywood shuffle1987
5528,american ninja 2 the confrontation,350000,4000000,4000000,3650000,11.428571428571429,1987,american ninja 2 the confrontation1987
2028,cry freedom,29000000,5899797,25899797,-3100203,0.8930964482758621,1987,cry freedom1987
2995,3 men and a baby,15000000,167780960,167780960,152780960,11.185397333333333,1987,3 men and a baby1987
2775,predator,18000000,59735548,98267558,80267558,5.459308777777777,1987,predator1987
2386,jaws 4 the revenge,23000000,15728335,15728335,-7271665,0.683840652173913,1987,jaws 4 the revenge1987
3244,good morning vietnam,13000000,123922370,123922370,110922370,9.53249,1987,good morning vietnam1987
3834,the lost boys,8500000,32222567,32222567,23722567,3.7908902352941176,1987,the lost boys1987
3046,the princess bride,15000000,30857000,30859628,15859628,2.0573085333333334,1987,the princess bride1987
1505,ishtar,40000000,14375181,14375181,-25624819,0.359379525,1987,ishtar1987
2179,the untouchables,25000000,76270454,76270454,51270454,3.05081816,1987,the untouchables1987
3011,lethal weapon,15000000,65192350,120192350,105192350,8.012823333333333,1987,lethal weapon1987
1920,the running man,30000000,38122000,38122000,8122000,1.2707333333333333,1987,the running man1987
4803,maurice,2600000,3147950,3198308,598308,1.2301184615384615,1987,maurice1987
4523,the barbarians,4000000,800000,800000,-3200000,0.2,1987,the barbarians1987
4866,the brave little toaster,2300000,0,0,-2300000,0.0,1987,the brave little toaster1987
2400,spaceballs,22700000,38119483,38119483,15419483,1.6792723788546255,1987,spaceballs1987
5197,the offspring,1100000,1355728,1355728,255728,1.23248,1987,the offspring1987
2919,wall street,16500000,43848100,43848100,27348100,2.657460606060606,1987,wall street1987
3172,fatal attraction,14000000,156645693,320100000,306100000,22.864285714285714,1987,fatal attraction1987
3675,malone,10000000,3000000,3000000,-7000000,0.3,1987,malone1987
5003,rivers edge,1900000,4600000,4600000,2700000,2.4210526315789473,1987,rivers edge1987
1436,the living daylights,40000000,51185000,191200000,151200000,4.78,1987,the living daylights1987
4598,creepshow 2,3500000,14000000,14000000,10500000,4.0,1987,creepshow 21987
2954,radio days,16000000,14792779,14792779,-1207221,0.9245486875,1987,radio days1987
1901,full metal jacket,30000000,45015999,45015999,15015999,1.5005333,1987,full metal jacket1987
3776,childs play,9000000,33244684,44196684,35196684,4.910742666666667,1988,childs play1988
2260,bright lights big city,25000000,16118077,16118077,-8881923,0.64472308,1988,bright lights big city1988
4411,lady in white,4700000,1705139,1705139,-2994861,0.3627955319148936,1988,lady in white1988
4137,school daze,6000000,14545844,14545844,8545844,2.424307333333333,1988,school daze1988
958,rambo iii,58000000,53715611,188715611,130715611,3.2537174310344827,1988,rambo iii1988
2766,big,18000000,114968774,151668774,133668774,8.426043,1988,big1988
3754,poltergeist iii,9500000,14114000,14114000,4614000,1.4856842105263157,1988,poltergeist iii1988
4007,action jackson,7000000,20257000,20257000,13257000,2.8938571428571427,1988,action jackson1988
1918,midnight run,30000000,38413606,81613606,51613606,2.7204535333333335,1988,midnight run1988
5067,bloodsport,1500000,11806119,11806119,10306119,7.870746,1988,bloodsport1988
3175,crocodile dundee 2,14000000,109306210,239606210,225606210,17.114729285714287,1988,crocodile dundee 21988
4139,mystic pizza,6000000,12793213,12793213,6793213,2.1322021666666666,1988,mystic pizza1988
4292,halloween 4 the return of michael myers,5000000,17768757,17768757,12768757,3.5537514,1988,halloween 4 the return of michael myers1988
3339,the land before time,12300000,48092846,81972846,69672846,6.6644590243902435,1988,the land before time1988
3255,a nightmare on elm street 4 the dream master,13000000,49369899,49369899,36369899,3.7976845384615383,1988,a nightmare on elm street 4 the dream master1988
4025,the last temptation of christ,7000000,8373585,8373585,1373585,1.1962264285714286,1988,the last temptation of christ1988
3259,young guns,13000000,44726644,44726644,31726644,3.440511076923077,1988,young guns1988
1793,scrooged,32000000,59450353,59450353,27450353,1.85782353125,1988,scrooged1988
2999,twins,15000000,111936388,216600000,201600000,14.44,1988,twins1988
2958,my stepmother is an alien,16000000,13854000,13854000,-2146000,0.865875,1988,my stepmother is an alien1988
695,who framed roger rabbit,70000000,154112492,351500000,281500000,5.021428571428571,1988,who framed roger rabbit1988
4530,prison,4000000,354704,354704,-3645296,0.088676,1988,prison1988
4701,phantasm ii,3000000,7282851,7282851,4282851,2.427617,1988,phantasm ii1988
4786,friday the 13th part vii the new blood,2800000,19170001,19170001,16370001,6.846428928571428,1988,friday the 13th part vii the new blood1988
2037,die hard,28000000,81350242,139109346,111109346,4.9681909285714285,1988,die hard1988
3006,beetlejuice,15000000,73839613,73887546,58887546,4.9258364,1988,beetlejuice1988
4514,talk radio,4000000,3468572,3468572,-531428,0.867143,1988,talk radio1988
4493,they live,4000000,13000000,13000774,9000774,3.2501935,1988,they live1988
4109,return of the living dead part ii,6200000,9205924,9205924,3005924,1.4848264516129033,1988,return of the living dead part ii1988
3187,dangerous liaisons,14000000,34700000,34700000,20700000,2.4785714285714286,1988,dangerous liaisons1988
2161,rain man,25000000,172825435,412800000,387800000,16.512,1988,rain man1988
4329,uhf,5000000,6157157,6157157,1157157,1.2314314,1989,uhf1989
4301,friday the 13th part viii jason takes manhattan,5000000,14343976,14343976,9343976,2.8687952,1989,friday the 13th part viii jason takes manhattan1989
3557,bill  teds excellent adventure,10000000,40485039,40485039,30485039,4.0485039,1989,bill  teds excellent adventure1989
3095,new york stories,15000000,10763469,10763469,-4236531,0.7175646,1989,new york stories1989
3473,major league,11000000,49793054,49793054,38793054,4.5266412727272725,1989,major league1989
5666,roger  me,140000,6706368,6706368,6566368,47.90262857142857,1989,roger  me1989
722,the abyss,70000000,54243125,54243125,-15756875,0.7749017857142857,1989,the abyss1989
2926,dead poets society,16400000,95860116,239500000,223100000,14.603658536585366,1989,dead poets society1989
1213,indiana jones and the last crusade,48000000,197171806,474171806,426171806,9.878579291666666,1989,indiana jones and the last crusade1989
3790,henry v,9000000,10161099,10176701,1176701,1.1307445555555555,1989,henry v1989
2728,sea of love,19000000,58571513,58571513,39571513,3.0827112105263157,1989,sea of love1989
1384,back to the future part ii,40000000,118450002,332000000,292000000,8.3,1989,back to the future part ii1989
3952,driving miss daisy,7500000,106593296,106593296,99093296,14.212439466666666,1989,driving miss daisy1989
1011,tango  cash,55000000,63408614,63408614,8408614,1.1528838909090908,1989,tango  cash1989
1877,harlem nights,30000000,60857262,95857262,65857262,3.1952420666666668,1989,harlem nights1989
5157,sex lies and videotape,1200000,24741667,36741667,35541667,30.618055833333333,1989,sex lies and videotape1989
1356,licence to kill,42000000,34667015,156167015,114167015,3.718262261904762,1989,licence to kill1989
3176,born on the fourth of july,14000000,70001698,70001698,56001698,5.000121285714286,1989,born on the fourth of july1989
1900,black rain,30000000,45892212,45892212,15892212,1.5297404,1989,black rain1989
2928,when harry met sallyâ,16000000,92823546,92961960,76961960,5.8101225,1989,when harry met sallyâ1989
4144,halloween 5 the revenge of michael myers,6000000,11642254,11642254,5642254,1.9403756666666667,1989,halloween 5 the revenge of michael myers1989
1626,batman,35000000,251188924,411348924,376348924,11.7528264,1989,batman1989
1892,star trek v the final frontier,30000000,52210049,70200000,40200000,2.34,1989,star trek v the final frontier1989
4128,a nightmare on elm street the dream child,6000000,22168359,22168359,16168359,3.6947265,1989,a nightmare on elm street the dream child1989
2822,troop beverly hills,18000000,7190505,7190505,-10809495,0.3994725,1989,troop beverly hills1989
3460,pet sematary,11500000,57469179,57469179,45969179,4.997319913043478,1989,pet sematary1989
5055,out of the dark,1600000,419428,419428,-1180572,0.2621425,1989,out of the dark1989
4124,do the right thing,6000000,26004026,26004026,20004026,4.334004333333334,1989,do the right thing1989
5066,kickboxer,1500000,14533681,14533681,13033681,9.689120666666666,1989,kickboxer1989
2643,were no angels,20000000,10555348,10555348,-9444652,0.5277674,1989,were no angels1989
3582,road house,10000000,30050028,30050028,20050028,3.0050028,1989,road house1989
2795,glory,18000000,26593580,26593580,8593580,1.477421111111111,1989,glory1989
2522,edward scissorhands,20000000,53976987,53976987,33976987,2.69884935,1990,edward scissorhands1990
2991,home alone,15000000,285761243,476684675,461684675,31.778978333333335,1990,home alone1990
5484,going under,500000,0,0,-500000,0.0,1990,going under1990
779,total recall,65000000,119394839,261400000,196400000,4.021538461538461,1990,total recall1990
3171,pretty woman,14000000,178406268,432645872,418645872,30.90327657142857,1990,pretty woman1990
2404,ghost,22000000,217631306,517600000,495600000,23.527272727272727,1990,ghost1990
2724,dances with wolves,19000000,184208842,424200000,405200000,22.326315789473686,1990,dances with wolves1990
702,die hard 2,70000000,117323878,239814025,169814025,3.4259146428571428,1990,die hard 21990
1398,back to the future part iii,40000000,88055283,244088654,204088654,6.10221635,1990,back to the future part iii1990
3232,teenage mutant ninja turtles,13500000,135265915,202000000,188500000,14.962962962962964,1990,teenage mutant ninja turtles1990
4685,spaced invaders,3000000,15000000,15000000,12000000,5.0,1990,spaced invaders1990
2200,goodfellas,25000000,46743809,46777347,21777347,1.87109388,1990,goodfellas1990
1052,the godfather part iii,54000000,66520529,66520529,12520529,1.2318616481481481,1990,the godfather part iii1990
5503,metropolitan,430000,2938000,2938000,2508000,6.832558139534884,1990,metropolitan1990
864,days of thunder,60000000,82670733,157670733,97670733,2.62784555,1990,days of thunder1990
1211,the adventures of ford fairlane,49000000,20423389,20423389,-28576611,0.41680385714285717,1990,the adventures of ford fairlane1990
3612,tremors,10000000,16667084,16667084,6667084,1.6667084,1990,tremors1990
2127,flatliners,26000000,61308153,61308153,35308153,2.3580058846153844,1990,flatliners1990
3267,childs play 2,13000000,26904572,34166572,21166572,2.628197846153846,1990,childs play 21990
4034,dark angel,7000000,4372561,4372561,-2627439,0.6246515714285714,1990,dark angel1990
1694,predator 2,35000000,28317513,54768418,19768418,1.5648119428571428,1990,predator 21990
1232,dick tracy,47000000,103738726,162738726,115738726,3.462526085106383,1990,dick tracy1990
3950,the blood of heroes,7700000,882290,882290,-6817710,0.11458311688311688,1990,the blood of heroes1990
1828,arachnophobia,31000000,53208180,53208180,22208180,1.7163929032258065,1990,arachnophobia1990
2123,kindergarten cop,26000000,91457688,202000000,176000000,7.769230769230769,1990,kindergarten cop1990
3614,mo better blues,10000000,16153000,16153000,6153000,1.6153,1990,mo better blues1990
1146,gremlins 2 the new batch,50000000,41476097,41476097,-8523903,0.82952194,1990,gremlins 2 the new batch1990
1843,the hunt for red october,30000000,120709866,200500000,170500000,6.683333333333334,1990,the hunt for red october1990
2588,quigley down under,20000000,21413105,21413105,1413105,1.07065525,1990,quigley down under1990
4287,house party 2,5000000,19438638,19438638,14438638,3.8877276,1991,house party 21991
2291,stone cold,25000000,9286314,9286314,-15713686,0.37145256,1991,stone cold1991
1865,the prince of tides,30000000,74787599,74787599,44787599,2.492919966666667,1991,the prince of tides1991
364,terminator 2 judgment day,100000000,203464105,515419827,415419827,5.15419827,1991,terminator 2 judgment day1991
814,hudson hawk,65000000,17218916,17218916,-47781084,0.2649064,1991,hudson hawk1991
4267,freddyâs dead the final nightmare,5000000,34872033,34872033,29872033,6.9744066,1991,freddyâs dead the final nightmare1991
2941,double impact,16000000,29090445,29090445,13090445,1.8181528125,1991,double impact1991
2545,bill  teds bogus journey,20000000,37537675,37537675,17537675,1.87688375,1991,bill  teds bogus journey1991
3469,fried green tomatoes,11000000,81204830,81204830,70204830,7.382257272727273,1991,fried green tomatoes1991
4085,boyz n the hood,6500000,56190094,56215095,49715095,8.648476153846154,1991,boyz n the hood1991
4024,warlock,7000000,8824553,8824553,1824553,1.2606504285714286,1991,warlock1991
2918,my girl,16500000,58011485,58011485,41511485,3.515847575757576,1991,my girl1991
4032,nikita,7000000,5017971,5017971,-1982029,0.716853,1991,nikita1991
2177,teenage mutant ninja turtles ii the secret of the ooze,25000000,78656813,78656813,53656813,3.14627252,1991,teenage mutant ninja turtles ii the secret of the ooze1991
3507,return to the blue lagoon,11000000,2000000,2000000,-9000000,0.18181818181818182,1991,return to the blue lagoon1991
3186,white fang,14000000,34729091,34729091,20729091,2.480649357142857,1991,white fang1991
5752,slacker,23000,1227508,1227508,1204508,53.36991304347826,1991,slacker1991
2495,the silence of the lambs,20000000,130726716,275726716,255726716,13.7863358,1991,the silence of the lambs1991
5733,the last waltz,35000,321952,322563,287563,9.216085714285715,1991,the last waltz1991
5493,straight out of brooklyn,450000,2712293,2712293,2262293,6.027317777777778,1991,straight out of brooklyn1991
4173,beastmaster 2 through the portal of time,6000000,773490,773490,-5226510,0.128915,1991,beastmaster 2 through the portal of time1991
1085,robin hood prince of thieves,50000000,165493908,390500000,340500000,7.81,1991,robin hood prince of thieves1991
1722,flight of the intruder,35000000,14471440,14471440,-20528560,0.4134697142857143,1991,flight of the intruder1991
1640,cape fear,35000000,79091969,182291969,147291969,5.208341971428571,1991,cape fear1991
1463,the doors,40000000,34416893,34416893,-5583107,0.860422325,1991,the doors1991
2369,the naked gun 2â½ the smell of fear,23000000,86930411,86930411,63930411,3.7795830869565217,1991,the naked gun 2â½ the smell of fear1991
2340,point break,24000000,43218387,83531958,59531958,3.48049825,1991,point break1991
2091,star trek vi the undiscovered country,27000000,74888996,96900000,69900000,3.588888888888889,1991,star trek vi the undiscovered country1991
1413,jfk,40000000,70405498,205400000,165400000,5.135,1991,jfk1991
2392,harley davidson and the marlboro man,23000000,7018525,7018525,-15981475,0.30515326086956523,1991,harley davidson and the marlboro man1991
5455,johnny suede,500000,55000,55000,-445000,0.11,1991,johnny suede1991
2341,the fisher king,24000000,41798224,41798224,17798224,1.7415926666666666,1991,the fisher king1991
4822,my own private idaho,2500000,6401336,6401336,3901336,2.5605344,1991,my own private idaho1991
701,hook,70000000,119654823,300854823,230854823,4.297926042857143,1991,hook1991
3810,due occhi diabolici,9000000,349618,349618,-8650382,0.03884644444444445,1991,due occhi diabolici1991
1848,the addams family,30000000,113502246,191502246,161502246,6.3834082,1991,the addams family1991
3839,haakon haakonsen,8500000,15024232,15024232,6524232,1.767556705882353,1991,haakon haakonsen1991
3909,showdown in little tokyo,8000000,2275557,2275557,-5724443,0.284444625,1991,showdown in little tokyo1991
2485,beauty and the beast,20000000,376057266,608431132,588431132,30.4215566,1991,beauty and the beast1991
1629,lethal weapon 3,35000000,144731527,319700000,284700000,9.134285714285713,1992,lethal weapon 31992
1264,patriot games,45000000,83287363,178100000,133100000,3.957777777777778,1992,patriot games1992
5166,reservoir dogs,1200000,2832029,2832029,1632029,2.360024166666667,1992,reservoir dogs1992
3575,the lawnmower man,10000000,32100816,32100816,22100816,3.2100816,1992,the lawnmower man1992
1388,a league of their own,40000000,107533925,132440066,92440066,3.31100165,1992,a league of their own1992
1704,hoffa,35000000,23365858,28391473,-6608527,0.8111849428571428,1992,hoffa1992
1769,a few good men,33000000,141340178,236500000,203500000,7.166666666666667,1992,a few good men1992
1402,bram stokers dracula,40000000,82522790,215862692,175862692,5.3965673,1992,bram stokers dracula1992
2488,home alone 2 lost in new york,20000000,173585516,358994850,338994850,17.9497425,1992,home alone 2 lost in new york1992
4477,the crying game,4000000,62546695,62546695,58546695,15.63667375,1992,the crying game1992
1660,malcolm x,35000000,48169910,48169910,13169910,1.376283142857143,1992,malcolm x1992
542,batman returns,80000000,162833635,266824291,186824291,3.3353036375,1992,batman returns1992
2496,waynes world,20000000,121697323,183097323,163097323,9.15486615,1992,waynes world1992
4928,night on earth,2000000,2015000,2022893,22893,1.0114465,1992,night on earth1992
2167,the bodyguard,25000000,121945720,410899039,385899039,16.43596156,1992,the bodyguard1992
3876,howards end,8000000,26124872,26317943,18317943,3.289742875,1992,howards end1992
1406,the last of the mohicans,40000000,75505856,75505856,35505856,1.8876464,1992,the last of the mohicans1992
3882,the player,8000000,21706101,28876702,20876702,3.60958775,1992,the player1992
4031,split second,7000000,5430822,5430822,-1569178,0.7758317142857143,1992,split second1992
1347,boomerang,42000000,70052444,131052444,89052444,3.1202962857142857,1992,boomerang1992
1362,hero,42000000,19487173,66787173,24787173,1.5901707857142857,1992,hero1992
1744,radio flyer,35000000,4651977,4651977,-30348023,0.13291362857142858,1992,radio flyer1992
3471,my cousin vinny,11000000,52929168,52929168,41929168,4.811742545454545,1992,my cousin vinny1992
4357,light sleeper,5000000,1050861,1050861,-3949139,0.2101722,1992,light sleeper1992
2032,aladdin,28000000,217350219,504050219,476050219,18.001793535714285,1992,aladdin1992
1012,death becomes her,55000000,58422650,149022650,94022650,2.7095027272727275,1992,death becomes her1992
1445,medicine man,40000000,44948240,44948240,4948240,1.123706,1992,medicine man1992
3169,unforgiven,14400000,101157447,159157447,144757447,11.05260048611111,1992,unforgiven1992
3375,the muppet christmas carol,12000000,27281507,27492918,15492918,2.2910765,1992,the muppet christmas carol1992
4355,a midnight clear,5000000,1526697,1526697,-3473303,0.3053394,1992,a midnight clear1992
3551,the mighty ducks,10000000,50752337,50752337,40752337,5.0752337,1992,the mighty ducks1992
3486,raising cain,11000000,21171695,21171695,10171695,1.9246995454545455,1992,raising cain1992
1506,memoirs of an invisible man,40000000,14358033,14358033,-25641967,0.358950825,1992,memoirs of an invisible man1992
4016,buffy the vampire slayer,7000000,14231669,14231669,7231669,2.0330955714285714,1992,buffy the vampire slayer1992
1016,alien 3,55000000,54927174,158500000,103500000,2.881818181818182,1992,alien 31992
3323,glengarry glen ross,12500000,10725228,10725228,-1774772,0.85801824,1992,glengarry glen ross1992
3498,whats eating gilbert grape,11000000,9170214,9170214,-1829786,0.8336558181818182,1993,whats eating gilbert grape1993
1761,the age of innocence,34000000,32014993,32014993,-1985007,0.9416174411764706,1993,the age of innocence1993
3412,fortress,12000000,6730578,46730578,34730578,3.8942148333333333,1993,fortress1993
3495,army of darkness,11000000,11502976,21502976,10502976,1.954816,1993,army of darkness1993
2160,mrs doubtfire,25000000,219195051,441286003,416286003,17.65144012,1993,mrs doubtfire1993
3991,the piano,7000000,40157856,40168957,33168957,5.738422428571429,1993,the piano1993
3063,the remains of the day,15000000,22954968,63954968,48954968,4.263664533333333,1993,the remains of the day1993
824,jurassic park,63000000,395708305,1038812584,975812584,16.489088634920634,1993,jurassic park1993
2507,free willy,20000000,77698625,153698625,133698625,7.68493125,1993,free willy1993
4684,jason goes to hell the final friday,3000000,15935068,15935068,12935068,5.311689333333334,1993,jason goes to hell the final friday1993
3030,whats love got to do with it,15000000,39100956,39100956,24100956,2.6067304,1993,whats love got to do with it1993
1259,the pelican brief,45000000,100768056,187995859,142995859,4.177685755555555,1993,the pelican brief1993
3177,cool runnings,14000000,68856263,155056263,141056263,11.075447357142858,1993,cool runnings1993
3304,excessive force,13000000,1152117,1152117,-11847883,0.08862438461538462,1993,excessive force1993
3264,loaded weapon 1,13000000,27979399,27979399,14979399,2.1522614615384614,1993,loaded weapon 11993
2751,the nutcracker,19000000,2119994,2119994,-16880006,0.11157863157894737,1993,the nutcracker1993
2168,schindlerâs list,25000000,96898818,322197132,297197132,12.88788528,1993,schindlerâs list1993
1342,the firm,42000000,158340892,270340892,228340892,6.4366879047619046,1993,the firm1993
5773,el mariachi,7000,2040920,2041928,2034928,291.704,1993,el mariachi1993
1327,the fugitive,44000000,183875760,353715317,309715317,8.038984477272727,1993,the fugitive1993
3321,true romance,12500000,12281000,12309980,-190020,0.9847984,1993,true romance1993
1801,alive,32000000,36299670,36299670,4299670,1.1343646875,1993,alive1993
3064,nowhere to run,15000000,22189039,52189039,37189039,3.4792692666666665,1993,nowhere to run1993
2464,teenage mutant ninja turtles iii,21000000,42273609,42273609,21273609,2.013029,1993,teenage mutant ninja turtles iii1993
2441,robocop 3,22000000,10696210,10696210,-11303790,0.4861913636363636,1993,robocop 31993
4929,nemesis,2000000,2001124,2001124,1124,1.000562,1993,nemesis1993
2057,hocus pocus,28000000,39360491,39360491,11360491,1.4057318214285714,1993,hocus pocus1993
5027,ed and his dead mother,1800000,673,673,-1799327,0.0003738888888888889,1993,ed and his dead mother1993
3100,the dark half,15000000,9579068,9579068,-5420932,0.6386045333333333,1993,the dark half1993
4741,dead alive,3000000,242623,242623,-2757377,0.08087433333333334,1993,dead alive1993
4591,menace ii society,3500000,27731527,27731527,24231527,7.923293428571428,1993,menace ii society1993
4163,only the strong,6000000,3273588,3273588,-2726412,0.545598,1993,only the strong1993
2187,tombstone,25000000,56505065,56505065,31505065,2.2602026,1993,tombstone1993
4716,warlock the armageddon,3000000,3902679,3902679,902679,1.300893,1993,warlock the armageddon1993
1361,super mario bros,42000000,20844907,20844907,-21155093,0.4963073095238095,1993,super mario bros1993
4964,return of the living dead 3,2000000,21000,21000,-1979000,0.0105,1993,return of the living dead 31993
1745,bound by honor,35000000,4496583,4496583,-30503417,0.1284738,1993,bound by honor1993
4073,dazed and confused,6900000,7950889,7950889,1050889,1.1523027536231885,1993,dazed and confused1993
4089,the adventures of huck finn,6500000,24103594,24103594,17603594,3.7082452307692306,1993,the adventures of huck finn1993
3881,much ado about nothing,8000000,22549338,22549338,14549338,2.81866725,1993,much ado about nothing1993
2423,shadowlands,22000000,25842377,25842377,3842377,1.1746535,1993,shadowlands1993
789,cliffhanger,65000000,84049211,255000000,190000000,3.923076923076923,1993,cliffhanger1993
2125,philadelphia,26000000,77324422,201324422,175324422,7.743247,1993,philadelphia1993
2206,the beverly hillbillies,25000000,42222647,55598481,30598481,2.22393924,1993,the beverly hillbillies1993
2285,gettysburg,25000000,10731997,10731997,-14268003,0.42927988,1993,gettysburg1993
3190,poetic justice,14000000,27450453,27450453,13450453,1.960746642857143,1993,poetic justice1993
3164,groundhog day,14600000,70906973,70906973,56306973,4.85664198630137,1993,groundhog day1993
511,last action hero,85000000,50016394,137298489,52298489,1.6152763411764706,1993,last action hero1993
5361,ruby in paradise,800000,1001437,1001437,201437,1.25179625,1993,ruby in paradise1993
717,wolf,70000000,65011757,131011757,61011757,1.8715965285714287,1994,wolf1994
3897,the inkwell,8000000,8864699,8864699,864699,1.108087375,1994,the inkwell1994
5087,killing zoe,1500000,418953,418953,-1081047,0.279302,1994,killing zoe1994
1867,legends of the fall,30000000,66502573,160502573,130502573,5.350085766666667,1994,legends of the fall1994
1842,speed,30000000,121248145,283200000,253200000,9.44,1994,speed1994
2095,the jungle book,27000000,44342956,44342956,17342956,1.6423317037037037,1994,the jungle book1994
5075,exotica,1500000,5046118,5046118,3546118,3.364078666666667,1994,exotica1994
1152,on deadly ground,50000000,38590458,38590458,-11409542,0.77180916,1994,on deadly ground1994
5742,clerks,27000,3073428,3894240,3867240,144.23111111111112,1994,clerks1994
1145,beverly hills cop iii,50000000,42586861,119180938,69180938,2.38361876,1994,beverly hills cop iii1994
1098,interview with the vampire the vampire chronicles,50000000,105264608,223564608,173564608,4.47129216,1994,interview with the vampire the vampire chronicles1994
3528,there goes my baby,10500000,125169,125169,-10374831,0.011920857142857143,1994,there goes my baby1994
2765,the mask,18000000,119920129,351620129,333620129,19.534451611111113,1994,the mask1994
1187,babys day out,50000000,16581575,16581575,-33418425,0.3316315,1994,babys day out1994
2699,rapa nui,20000000,305070,305070,-19694930,0.0152535,1994,rapa nui1994
1254,the flintstones,45000000,130531208,358500000,313500000,7.966666666666667,1994,the flintstones1994
2638,3 ninjas kick back,20000000,11744960,11744960,-8255040,0.587248,1994,3 ninjas kick back1994
2629,bullets over broadway,20000000,13383747,13383747,-6616253,0.66918735,1994,bullets over broadway1994
2949,lãon,16000000,19284974,45284974,29284974,2.830310875,1994,lãon1994
1288,the river wild,45000000,46815000,94215000,49215000,2.0936666666666666,1994,the river wild1994
5388,hoop dreams,700000,7768371,11768371,11068371,16.811958571428573,1994,hoop dreams1994
608,the lion king,79300000,421785283,986214868,906914868,12.43650527112232,1994,the lion king1994
3288,serial mom,13000000,7881335,7881335,-5118665,0.6062565384615385,1994,serial mom1994
370,true lies,100000000,146282411,365300000,265300000,3.653,1994,true lies1994
1279,the specialist,45000000,57362581,57362581,12362581,1.2747240222222223,1994,the specialist1994
1262,the client,45000000,92115211,117615211,72615211,2.6136713555555557,1994,the client1994
3861,pulp fiction,8000000,107928762,212928762,204928762,26.61609525,1994,pulp fiction1994
1302,frankenstein,45000000,22006296,112006296,67006296,2.4890288,1994,frankenstein1994
3671,romeo is bleeding,10000000,3275585,3275585,-6724415,0.3275585,1994,romeo is bleeding1994
981,forrest gump,55000000,330151138,679850637,624850637,12.360920672727273,1994,forrest gump1994
2236,the shawshank redemption,25000000,28241469,28307092,3307092,1.13228368,1994,the shawshank redemption1994
3018,little women,15000000,50003303,50003303,35003303,3.3335535333333333,1994,little women1994
2826,ed wood,18000000,5828466,5828466,-12171534,0.32380366666666666,1994,ed wood1994
2927,dumb  dumber,16000000,127175374,246400000,230400000,15.4,1994,dumb  dumber1994
2406,the santa clause,22000000,144833357,189800000,167800000,8.627272727272727,1994,the santa clause1994
3350,ace ventura pet detective,12000000,72217396,107217396,95217396,8.934783,1994,ace ventura pet detective1994
3204,crooklyn,14000000,13024170,13024170,-975830,0.9302978571428572,1994,crooklyn1994
1489,renaissance man,40000000,24172899,24172899,-15827101,0.604322475,1994,renaissance man1994
1006,stargate,55000000,71565669,196565669,141565669,3.5739212545454544,1994,stargate1994
829,clear and present danger,62000000,122012656,207500000,145500000,3.346774193548387,1994,clear and present danger1994
828,wyatt earp,63000000,25052000,25052000,-37948000,0.39765079365079364,1994,wyatt earp1994
3607,sugar hill,10000000,18272447,18423914,8423914,1.8423914,1994,sugar hill1994
3798,pcu,9000000,4333569,4333569,-4666431,0.48150766666666667,1994,pcu1994
1528,the hudsucker proxy,40000000,2816518,14938149,-25061851,0.373453725,1994,the hudsucker proxy1994
1557,star trek generations,38000000,75671262,120000000,82000000,3.1578947368421053,1994,star trek generations1994
1895,naked gun 33 13 the final insult,30000000,51041856,51041856,21041856,1.7013952,1994,naked gun 33 13 the final insult1994
3586,a low down dirty shame,10000000,29317886,29317886,19317886,2.9317886,1994,a low down dirty shame1994
3718,police academy 7 mission to moscow,10000000,126247,126247,-9873753,0.0126247,1994,police academy 7 mission to moscow1994
1470,the shadow,40000000,31835600,31835600,-8164400,0.79589,1994,the shadow1994
1002,disclosure,55000000,83015089,212200000,157200000,3.8581818181818184,1994,disclosure1994
3885,wes cravens new nightmare,8000000,18090181,18090181,10090181,2.261272625,1994,wes cravens new nightmare1994
4347,heavenly creatures,5000000,3046086,5438120,438120,1.087624,1994,heavenly creatures1994
1682,street fighter,35000000,33423000,99423000,64423000,2.8406571428571428,1994,street fighter1994
1455,rihie rih,40000000,38087756,38087756,-1912244,0.9521939,1994,rihie rih1994
4424,four weddings and a funeral,4500000,52700832,242895809,238395809,53.97684644444445,1994,four weddings and a funeral1994
2055,timecop,28000000,44853581,102053581,74053581,3.64477075,1994,timecop1994
2371,bad boys,23000000,65647413,141247413,118247413,6.141191869565217,1995,bad boys1995
997,casper,55000000,100328194,282300000,227300000,5.132727272727273,1995,casper1995
1942,virtuosity,30000000,23998226,23998226,-6001774,0.7999408666666666,1995,virtuosity1995
2589,to die for,20000000,21284514,27688744,7688744,1.3844372,1995,to die for1995
4111,mallrats,6100000,2108367,2108367,-3991633,0.3456339344262295,1995,mallrats1995
1873,babe,30000000,63658910,246100000,216100000,8.203333333333333,1995,babe1995
3386,tales from the crypt demon knight,12000000,21089146,21089146,9089146,1.7574288333333334,1995,tales from the crypt demon knight1995
435,cutthroat island,92000000,10017322,18517322,-73482678,0.20127523913043477,1995,cutthroat island1995
3140,things to do in denver when youre dead,15000000,529766,529766,-14470234,0.03531773333333333,1995,things to do in denver when youre dead1995
987,pocahontas,55000000,141579773,347100000,292100000,6.310909090909091,1995,pocahontas1995
453,die hard with a vengeance,90000000,100012499,366101666,276101666,4.067796288888889,1995,die hard with a vengeance1995
1854,se7en,30000000,100125643,328125643,298125643,10.937521433333334,1995,se7en1995
4297,halloween the curse of michael myers,5000000,15126948,15126948,10126948,3.0253896,1995,halloween the curse of michael myers1995
3764,richard iii,9200000,2684904,4199334,-5000666,0.456449347826087,1995,richard iii1995
1000,crimson tide,55000000,91387195,159387195,104387195,2.897949,1995,crimson tide1995
2363,the thief and the cobbler,24000000,669276,669276,-23330724,0.0278865,1995,the thief and the cobbler1995
5574,the incredibly true adventure of two girls in love,250000,2210408,2477155,2227155,9.90862,1995,the incredibly true adventure of two girls in love1995
785,jumanji,65000000,100458310,262758310,197758310,4.042435538461539,1995,jumanji1995
4505,the jerky boys,4000000,7555256,7555256,3555256,1.888814,1995,the jerky boys1995
2509,mortal kombat,20000000,70433227,122133227,102133227,6.10666135,1995,mortal kombat1995
2146,highlander the final dimension,26000000,13738574,13738574,-12261426,0.5284066923076923,1995,highlander the final dimension1995
5715,the brothers mcmullen,50000,10426506,10426506,10376506,208.53012,1995,the brothers mcmullen1995
757,money train,68000000,35324232,77224232,9224232,1.1356504705882353,1995,money train1995
2415,the net,22000000,50621733,110521733,88521733,5.023715136363636,1995,the net1995
774,apollo 13,65000000,173772767,335802271,270802271,5.166188784615384,1995,apollo 131995
4482,leaving las vegas,4000000,31983777,49800000,45800000,12.45,1995,leaving las vegas1995
1650,species,35000000,60054449,113354449,78354449,3.2386985428571426,1995,species1995
2062,rob roy,28000000,31390587,31390587,3390587,1.1210923928571428,1995,rob roy1995
684,braveheart,72000000,75545647,209045244,137045244,2.9034061666666666,1995,braveheart1995
831,the american president,62000000,60022813,107822813,45822813,1.739077629032258,1995,the american president1995
4511,four rooms,4000000,4301000,4301000,301000,1.07525,1995,four rooms1995
3505,the perez family,11000000,2794056,2794056,-8205944,0.2540050909090909,1995,the perez family1995
660,first knight,75000000,37361412,127361412,52361412,1.69815216,1995,first knight1995
3504,othello,11000000,2844379,2844379,-8155621,0.2585799090909091,1995,othello1995
4592,friday,3500000,27467564,27936778,24436778,7.981936571428571,1995,friday1995
3476,dead man walking,11000000,39387284,83088295,72088295,7.553481363636363,1995,dead man walking1995
5070,kids,1500000,7412216,20412216,18912216,13.608144,1995,kids1995
1162,assassins,50000000,30306268,83306268,33306268,1.66612536,1995,assassins1995
2409,the bridges of madison county,22000000,71516617,175516617,153516617,7.978028045454545,1995,the bridges of madison county1995
2920,sense and sensibility,16500000,42993774,134993774,118493774,8.181440848484849,1995,sense and sensibility1995
1836,toy story,30000000,191796233,364545516,334545516,12.1515172,1995,toy story1995
4823,before sunrise,2500000,5274005,5690220,3190220,2.276088,1995,before sunrise1995
1293,the indian in the cupboard,45000000,35627222,35627222,-9372778,0.7917160444444444,1995,the indian in the cupboard1995
2302,tank girl,25000000,4064333,4064333,-20935667,0.16257332,1995,tank girl1995
1313,nixon,45000000,13668249,34668249,-10331751,0.7704055333333333,1995,nixon1995
4001,desperado,7000000,25532388,25532388,18532388,3.647484,1995,desperado1995
2559,copycat,20000000,32051917,32051917,12051917,1.60259585,1995,copycat1995
1503,kiss of death,40000000,14942422,14942422,-25057578,0.37356055,1995,kiss of death1995
1194,jade,50000000,9812870,9812870,-40187130,0.1962574,1995,jade1995
1192,the scarlet letter,50000000,10359006,10359006,-39640994,0.20718012,1995,the scarlet letter1995
852,goldeneye,60000000,106429941,356429941,296429941,5.940499016666666,1995,goldeneye1995
1496,showgirls,40000000,20350754,37750754,-2249246,0.94376885,1995,showgirls1995
1189,fair game,50000000,11497497,26097497,-23902503,0.52194994,1995,fair game1995
109,waterworld,175000000,88246220,264246220,89246220,1.5099784,1995,waterworld1995
2833,restoration,18000000,4100000,4100000,-13900000,0.22777777777777777,1995,restoration1995
1823,mr hollandâs opus,31000000,82582604,106282604,75282604,3.4284710967741936,1995,mr hollandâs opus1995
2017,12 monkeys,29000000,57141459,168841459,139841459,5.822119275862069,1995,12 monkeys1995
1807,the quick and the dead,32000000,18552460,18552460,-13447540,0.579764375,1995,the quick and the dead1995
897,under siege 2 dark territory,60000000,50024083,104324083,44324083,1.7387347166666667,1995,under siege 2 dark territory1995
365,batman forever,100000000,184031112,336529144,236529144,3.36529144,1995,batman forever1995
1834,get shorty,30250000,72021008,115021008,84771008,3.8023473719008263,1995,get shorty1995
3195,vampire in brooklyn,14000000,19637147,19637147,5637147,1.4026533571428572,1995,vampire in brooklyn1995
4127,the usual suspects,6000000,23341568,34449356,28449356,5.741559333333333,1995,the usual suspects1995
2605,home for the holidays,20000000,17468887,22119269,2119269,1.10596345,1995,home for the holidays1995
1070,casino,52000000,42438300,110400000,58400000,2.123076923076923,1995,casino1995
1118,outbreak,50000000,67823573,190023573,140023573,3.80047146,1995,outbreak1995
4191,men of war,6000000,0,0,-6000000,0.0,1995,men of war1995
3230,clueless,13700000,56598476,56598476,42898476,4.131275620437957,1995,clueless1995
3220,jefferson in paris,14000000,2461628,2461628,-11538372,0.17583057142857142,1995,jefferson in paris1995
1110,congo,50000000,81022333,152022333,102022333,3.04044666,1995,congo1995
959,sabrina,58000000,53458319,87100000,29100000,1.5017241379310344,1995,sabrina1995
4143,tales from the hood,6000000,11784569,11784569,5784569,1.9640948333333332,1995,tales from the hood1995
519,judge dredd,85000000,34687912,113487912,28487912,1.3351519058823529,1995,judge dredd1995
2246,don juan demarco,25000000,22032635,22032635,-2967365,0.8813054,1995,don juan demarco1995
1849,ace ventura when nature calls,30000000,108360063,212400000,182400000,7.08,1995,ace ventura when nature calls1995
1234,the cable guy,47000000,60240295,102825796,55825796,2.187782893617021,1996,the cable guy1996
3299,faithful,13000000,2104439,2104439,-10895561,0.1618799230769231,1996,faithful1996
1331,the juror,44000000,22730924,22730924,-21269076,0.516611909090909,1996,the juror1996
1329,sleepers,44000000,53300852,165600852,121600852,3.7636557272727273,1996,sleepers1996
539,mission impossible,80000000,180981886,457697994,377697994,5.721224925,1996,mission impossible1996
5769,bang,10000,527,527,-9473,0.0527,1996,bang1996
3061,the craft,15000000,24769466,55669466,40669466,3.7112977333333332,1996,the craft1996
1304,multiplicity,45000000,20133326,20133326,-24866674,0.44740724444444446,1996,multiplicity1996
1308,the phantom,45000000,17220599,17220599,-27779401,0.3826799777777778,1996,the phantom1996
882,jingle all the way,60000000,60592389,129832389,69832389,2.16387315,1996,jingle all the way1996
566,space jam,80000000,90463534,250200000,170200000,3.1275,1996,space jam1996
3166,romeojuliet,14500000,46338728,147542381,133042381,10.175336620689656,1996,romeojuliet1996
699,ransom,70000000,136492681,308700000,238700000,4.41,1996,ransom1996
2753,kansas city,19000000,1353824,1353824,-17646176,0.0712538947368421,1996,kansas city1996
4815,that thing you do,2500000,25857416,34557416,32057416,13.8229664,1996,that thing you do1996
1789,phenomenon,32000000,104636382,152036382,120036382,4.7511369375,1996,phenomenon1996
891,up close  personal,60000000,51045801,100645801,40645801,1.6774300166666667,1996,up close  personal1996
626,independence day,75000000,306169255,817400878,742400878,10.898678373333333,1996,independence day1996
594,daylight,80000000,32908290,158908290,78908290,1.986353625,1996,daylight1996
4308,lone star,5000000,12961389,12961389,7961389,2.5922778,1996,lone star1996
1240,mary reilly,47000000,5707094,12900000,-34100000,0.274468085106383,1996,mary reilly1996
4852,get on the bus,2400000,5691854,5691854,3291854,2.371605833333333,1996,get on the bus1996
4432,bound,4500000,3802260,7011317,2511317,1.5580704444444444,1996,bound1996
3418,girl 6,12000000,4880941,4880941,-7119059,0.4067450833333333,1996,girl 61996
1852,the first wives club,30000000,105489203,181489203,151489203,6.0496401,1996,the first wives club1996
3955,rumble in the bronx,7500000,32281907,36238752,28738752,4.8318336,1996,rumble in the bronx1996
2576,from dusk till dawn,20000000,25728961,25732986,5732986,1.2866493,1996,from dusk till dawn1996
3901,the pallbearer,8000000,5656388,5656388,-2343612,0.7070485,1996,the pallbearer1996
5133,trees lounge,1300000,749741,749741,-550259,0.5767238461538462,1996,trees lounge1996
4004,fargo,7000000,24567751,51204567,44204567,7.314938142857143,1996,fargo1996
4049,les visiteurs,7000000,659000,98754000,91754000,14.107714285714286,1996,les visiteurs1996
4405,sling blade,4833610,24475416,34175000,29341390,7.070284942310199,1996,sling blade1996
3000,scream,15000000,103046663,173046663,158046663,11.5364442,1996,scream1996
4661,trainspotting,3100000,16501785,71558971,68458971,23.083539032258063,1996,trainspotting1996
5249,walking and talking,1000000,1287480,1615787,615787,1.615787,1996,walking and talking1996
1548,sgt bilko,39000000,30356589,37956589,-1043411,0.9732458717948718,1996,sgt bilko1996
5543,when the cats away,300000,1652472,2525984,2225984,8.419946666666666,1996,when the cats away1996
1278,jack,45000000,58617334,58617334,13617334,1.3026074222222221,1996,jack1996
1353,the mirror has two faces,42000000,41267469,41267469,-732531,0.9825587857142857,1996,the mirror has two faces1996
3333,the funeral,12500000,1212799,1412799,-11087201,0.11302392,1996,the funeral1996
2156,flipper,25530000,20080020,30593313,5063313,1.1983279670975324,1996,flipper1996
1814,bogus,32000000,4357406,4357406,-27642594,0.1361689375,1996,bogus1996
1281,tin cup,45000000,53854588,75854588,30854588,1.6856575111111112,1996,tin cup1996
1248,courage under fire,46000000,59003384,100833145,54833145,2.1920248913043476,1996,courage under fire1996
637,the rock,75000000,134069511,336069511,261069511,4.480926813333333,1996,the rock1996
1303,the glimmer man,45000000,20404841,36404841,-8595159,0.8089964666666667,1996,the glimmer man1996
4014,flirting with disaster,7000000,14853474,16149180,9149180,2.3070257142857145,1996,flirting with disaster1996
3268,harriet the spy,13000000,26570048,26570048,13570048,2.0438498461538464,1996,harriet the spy1996
1245,star trek first contact,46000000,92027888,150000000,104000000,3.260869565217391,1996,star trek first contact1996
1641,the english patient,35000000,78716374,231710008,196710008,6.620285942857143,1996,the english patient1996
590,mars attacks,80000000,37771017,101371017,21371017,1.2671377125,1996,mars attacks1996
4427,secrets  lies,4500000,13417292,13417292,8917292,2.9816204444444443,1996,secrets  lies1996
973,dragonheart,57000000,51364680,104364680,47364680,1.830959298245614,1996,dragonheart1996
1172,escape from la,50000000,25426861,25426861,-24573139,0.50853722,1996,escape from la1996
2290,mrs winterbourne,25000000,10039566,10039566,-14960434,0.40158264,1996,mrs winterbourne1996
2644,everyone says i love you,20000000,9725847,34600000,14600000,1.73,1996,everyone says i love you1996
4604,shes the one,3500000,9482579,13795053,10295053,3.941443714285714,1996,shes the one1996
1159,striptease,50000000,33109743,113309743,63309743,2.26619486,1996,striptease1996
3873,a thin line between love  hate,8000000,34873513,34873513,26873513,4.359189125,1996,a thin line between love  hate1996
4362,bottle rocket,5000000,407488,407488,-4592512,0.0814976,1996,bottle rocket1996
1014,executive decision,55000000,56679192,122079192,67079192,2.2196216727272726,1996,executive decision1996
1616,ghosts of mississippi,36000000,13052741,13052741,-22947259,0.3625761388888889,1996,ghosts of mississippi1996
2283,michael collins,25000000,11092559,27572844,2572844,1.10291376,1996,michael collins1996
2270,maximum risk,25000000,14102929,51702929,26702929,2.06811716,1996,maximum risk1996
5359,welcome to the dollhouse,800000,4198137,5034794,4234794,6.2934925,1996,welcome to the dollhouse1996
3669,crash,10000000,3357324,3357324,-6642676,0.3357324,1996,crash1996
1387,a time to kill,40000000,108766007,152266007,112266007,3.806650175,1996,a time to kill1996
765,last man standing,67000000,18115927,18115927,-48884073,0.2703869701492537,1996,last man standing1996
2388,marvins room,23000000,12803305,12803305,-10196695,0.5566654347826087,1996,marvins room1996
481,twister,88000000,241688385,495700000,407700000,5.632954545454545,1996,twister1996
2793,spy hard,18000000,26936265,26936265,8936265,1.4964591666666667,1996,spy hard1996
378,the hunchback of notre dame,100000000,100138851,325500000,225500000,3.255,1996,the hunchback of notre dame1996
2263,the adventures of pinocchio,25000000,15382170,36682170,11682170,1.4672868,1996,the adventures of pinocchio1996
377,eraser,100000000,101295562,234400000,134400000,2.344,1996,eraser1996
1575,extreme measures,38000000,17378193,17378193,-20621807,0.45732086842105263,1996,extreme measures1996
1086,jerry maguire,50000000,153952592,274000000,224000000,5.48,1996,jerry maguire1996
1497,city hall,40000000,20278055,20278055,-19721945,0.506951375,1996,city hall1996
4722,basquiat,3000000,2962051,2962051,-37949,0.9873503333333333,1996,basquiat1996
807,the long kiss goodnight,65000000,33447612,33447612,-31552388,0.5145786461538462,1996,the long kiss goodnight1996
1481,the island of dr moreau,40000000,27682712,27682712,-12317288,0.6920678,1996,the island of dr moreau1996
3355,beavis and butthead do america,12000000,63118386,63118386,51118386,5.2598655,1996,beavis and butthead do america1996
2573,eye for an eye,20000000,26792700,26792700,6792700,1.339635,1996,eye for an eye1996
1961,fled,30000000,17192205,19892205,-10107795,0.6630735,1996,fled1996
4739,freeway,3000000,295493,295493,-2704507,0.09849766666666666,1996,freeway1996
1578,white squall,38000000,10229300,10229300,-27770700,0.2691921052631579,1996,white squall1996
4196,emma,5900000,22231658,37831658,31931658,6.412145423728814,1996,emma1996
2240,kingpin,25000000,25023424,32223424,7223424,1.28893696,1996,kingpin1996
3199,thinner,14000000,15171475,15171475,1171475,1.0836767857142857,1996,thinner1996
989,the nutty professor,55000000,128814019,273814019,218814019,4.978436709090909,1996,the nutty professor1996
4216,shine,5500000,35811509,36672493,31172493,6.667726,1996,shine1996
4948,stonewall,2000000,304602,304602,-1695398,0.152301,1996,stonewall1996
3773,set it off,9000000,36049108,36049108,27049108,4.0054564444444445,1996,set it off1996
1750,le hussard sur le toit,35000000,1320043,1320043,-33679957,0.037715514285714284,1996,le hussard sur le toit1996
791,broken arrow,65000000,70645997,148345997,83345997,2.2822461076923077,1996,broken arrow1996
1020,evita,55000000,50047179,151947179,96947179,2.7626759818181816,1996,evita1996
2456,my fellow americans,21500000,22331846,22331846,831846,1.038690511627907,1996,my fellow americans1996
5615,swingers,200000,4505922,6618578,6418578,33.09289,1996,swingers1996
3559,happy gilmore,10000000,38623460,41004412,31004412,4.1004412,1996,happy gilmore1996
2838,unforgettable,18000000,2483790,2483790,-15516210,0.13798833333333332,1996,unforgettable1996
1024,the ghost and the darkness,55000000,38564422,38564422,-16435578,0.7011713090909091,1996,the ghost and the darkness1996
1036,the fan,55000000,18582965,18582965,-36417035,0.3378720909090909,1996,the fan1996
3147,silent trigger,15000000,76382,76382,-14923618,0.005092133333333334,1996,silent trigger1996
2831,hamlet,18000000,4501094,7129670,-10870330,0.3960927777777778,1996,hamlet1996
1035,chain reaction,55000000,21226204,60209334,5209334,1.0947151636363637,1996,chain reaction1996
467,the saint,90000000,61363304,169400000,79400000,1.8822222222222222,1997,the saint1997
1741,warriors of virtue,35000000,6448817,6448817,-28551183,0.18425191428571427,1997,warriors of virtue1997
451,contact,90000000,100920329,165900000,75900000,1.8433333333333333,1997,contact1997
2203,nothing to lose,25000000,44480039,64594061,39594061,2.58376244,1997,nothing to lose1997
3705,rien ne va plus,10000000,245359,5045359,-4954641,0.5045359,1997,rien ne va plus1997
3024,wag the dog,15000000,43057470,64252038,49252038,4.2834692,1997,wag the dog1997
971,devils advocate,57000000,61007424,153007424,96007424,2.6843407719298247,1997,devils advocate1997
4299,eves bayou,5000000,14843425,14843425,9843425,2.968685,1997,eves bayou1997
4285,the apostle,5000000,20733485,21277770,16277770,4.255554,1997,the apostle1997
472,volcano,90000000,47546796,120100000,30100000,1.3344444444444445,1997,volcano1997
2076,a simple wish,28000000,8165213,8165213,-19834787,0.29161475,1997,a simple wish1997
473,the devils own,90000000,42885593,140900000,50900000,1.5655555555555556,1997,the devils own1997
4340,the sweet hereafter,5000000,4306697,7951247,2951247,1.5902494,1997,the sweet hereafter1997
491,air force one,85000000,172956409,315268353,230268353,3.7090394470588235,1997,air force one1997
931,event horizon,60000000,26673242,26673242,-33326758,0.4445540333333333,1997,event horizon1997
438,men in black,90000000,250690539,587790539,497790539,6.5310059888888885,1997,men in black1997
3397,def jams how to be a player,12000000,14010363,14010363,2010363,1.16753025,1997,def jams how to be a player1997
4364,albino alligator,5000000,353480,353480,-4646520,0.070696,1997,albino alligator1997
560,con air,80000000,101117573,224117573,144117573,2.8014696625,1997,con air1997
3438,critical care,12000000,220175,220175,-11779825,0.018347916666666665,1997,critical care1997
1324,shadow conspiracy,45000000,2154540,2154540,-42845460,0.04787866666666667,1997,shadow conspiracy1997
919,the relic,60000000,33956608,33956608,-26043392,0.5659434666666666,1997,the relic1997
2150,blood and wine,26000000,1083350,1083350,-24916650,0.04166730769230769,1997,blood and wine1997
5549,the watermelon woman,300000,42735,42735,-257265,0.14245,1997,the watermelon woman1997
554,faceoff,80000000,112276146,241200000,161200000,3.015,1997,faceoff1997
992,george of the jungle,55000000,105263257,174463257,119463257,3.1720592181818184,1997,george of the jungle1997
4589,the full monty,3500000,45950122,261249383,257749383,74.64268085714286,1997,the full monty1997
2208,money talks,25000000,41076865,41076865,16076865,1.6430746,1997,money talks1997
42,titanic,200000000,659363944,2208208395,2008208395,11.041041975,1997,titanic1997
1580,switchback,38000000,6504442,6504442,-31495558,0.17116952631578947,1997,switchback1997
1747,smillas sense of snow,35000000,2221994,2221994,-32778006,0.06348554285714286,1997,smillas sense of snow1997
3023,cop land,15000000,44906632,63706632,48706632,4.2471088,1997,cop land1997
1815,cats dont dance,32000000,3588602,3588602,-28411398,0.1121438125,1997,cats dont dance1997
2869,i know what you did last summer,17000000,72250091,125250091,108250091,7.3676524117647055,1997,i know what you did last summer1997
3054,grosse pointe blank,15000000,28084357,31070412,16070412,2.0713608,1997,grosse pointe blank1997
2551,selena,20000000,35450113,35450113,15450113,1.77250565,1997,selena1997
1560,mouse hunt,38000000,61894591,61894591,23894591,1.6288050263157894,1997,mouse hunt1997
889,the jackal,60000000,54956941,159356941,99356941,2.655949016666667,1997,the jackal1997
523,fathers day,85000000,28681080,35681080,-49318920,0.4197774117647059,1997,fathers day1997
3058,boogie nights,15000000,26410771,43111725,28111725,2.874115,1997,boogie nights1997
3626,love jones,10000000,12554569,12554569,2554569,1.2554569,1997,love jones1997
572,conspiracy theory,80000000,76118990,142783718,62783718,1.784796475,1997,conspiracy theory1997
900,alien resurrection,60000000,47795018,160700000,100700000,2.6783333333333332,1997,alien resurrection1997
5578,love and other catastrophes,250000,212285,743216,493216,2.972864,1997,love and other catastrophes1997
1701,midnight in the garden of good and evil,35000000,25078937,25078937,-9921063,0.7165410571428571,1997,midnight in the garden of good and evil1997
5569,chasing amy,250000,12006514,15155095,14905095,60.62038,1997,chasing amy1997
4791,ulees gold,2700000,9054736,15600000,12900000,5.777777777777778,1997,ulees gold1997
564,flubber,80000000,92993801,177993801,97993801,2.2249225125,1997,flubber1997
2152,the grimm brothers snow white,26000000,5000,5000,-25995000,0.0001923076923076923,1997,the grimm brothers snow white1997
4717,8 heads in a duffel bag,3000000,3602884,4002884,1002884,1.3342946666666666,1997,8 heads in a duffel bag1997
4515,waiting for guffman,4000000,2922988,2922988,-1077012,0.730747,1997,waiting for guffman1997
5264,dream with the fishes,1000000,542909,542909,-457091,0.542909,1997,dream with the fishes1997
2641,deconstructing harry,20000000,10686841,10686841,-9313159,0.53434205,1997,deconstructing harry1997
3361,jackie brown,12000000,39673162,74727492,62727492,6.227291,1997,jackie brown1997
3953,soul food,7500000,43492389,43492389,35992389,5.7989852,1997,soul food1997
1365,mchales navy,42000000,4408420,4408420,-37591580,0.10496238095238095,1997,mchales navy1997
5495,sunday,450000,410919,450349,349,1.0007755555555555,1997,sunday1997
1645,la confidential,35000000,64604977,126204977,91204977,3.605856485714286,1997,la confidential1997
1040,turbulence,55000000,11532774,11532774,-43467226,0.2096868,1997,turbulence1997
2332,scream 2,24000000,101363301,172363301,148363301,7.181804208333333,1997,scream 21997
2972,steel,16000000,1686429,1686429,-14313571,0.1054018125,1997,steel1997
1274,anaconda,45000000,65598907,136998907,91998907,3.0444201555555557,1997,anaconda1997
1137,the game,50000000,48265581,80369970,30369970,1.6073994,1997,the game1997
419,the fifth element,95000000,63570862,263898761,168898761,2.777881694736842,1997,the fifth element1997
1444,the rainmaker,40000000,45916769,45916769,5916769,1.147919225,1997,the rainmaker1997
1446,amistad,40000000,44212592,58250151,18250151,1.456253775,1997,amistad1997
4549,the last time i committed suicide,4000000,12836,12836,-3987164,0.003209,1997,the last time i committed suicide1997
4673,air bud,3000000,24646936,27788649,24788649,9.262883,1997,air bud1997
2093,kiss the girls,27000000,60527873,60527873,33527873,2.2417730740740742,1997,kiss the girls1997
1251,liar liar,45000000,181410615,302710615,257710615,6.726902555555555,1997,liar liar1997
2820,the ice storm,18000000,8038061,16011975,-1988025,0.8895541666666666,1997,the ice storm1997
1647,in  out,35000000,63826569,83226569,48226569,2.3779019714285714,1997,in  out1997
276,batman  robin,125000000,107325195,238317814,113317814,1.906542512,1997,batman  robin1997
1610,breakdown,36000000,50159144,50159144,14159144,1.3933095555555555,1997,breakdown1997
1923,mortal kombat annihilation,30000000,35927406,51327406,21327406,1.7109135333333334,1997,mortal kombat annihilation1997
1138,gi jane,50000000,48169156,48169156,-1830844,0.96338312,1997,gi jane1997
1059,anastasia,53000000,58403409,139801096,86801096,2.6377565283018867,1997,anastasia1997
5746,in the company of men,25000,2883661,2883661,2858661,115.34644,1997,in the company of men1997
603,the postman,80000000,17650704,20841123,-59158877,0.2605140375,1997,the postman1997
2778,austin powers international man of mystery,18000000,53883989,67683989,49683989,3.760221611111111,1997,austin powers international man of mystery1997
3917,prefontaine,8000000,590817,590817,-7409183,0.073852125,1997,prefontaine1997
2624,the man who knew too little,20000000,13801755,13801755,-6198245,0.69008775,1997,the man who knew too little1997
4712,kama sutra,3000000,4109095,4109095,1109095,1.3696983333333332,1997,kama sutra1997
3536,good will hunting,10000000,138433435,225925989,215925989,22.5925989,1997,good will hunting1997
1667,donnie brasco,35000000,41954997,65303052,30303052,1.8658014857142857,1997,donnie brasco1997
1088,as good as it gets,50000000,148478011,314111923,264111923,6.28223846,1997,as good as it gets1997
1243,my best friends wedding,46000000,126813153,298923419,252923419,6.4983351956521735,1997,my best friends wedding1997
390,starship troopers,100000000,54768952,121100000,21100000,1.211,1997,starship troopers1997
5762,pink flamingos,12000,413802,413802,401802,34.4835,1997,pink flamingos1997
323,tomorrow never dies,110000000,125304276,339504276,229504276,3.086402509090909,1997,tomorrow never dies1997
1429,spawn,40000000,54979992,87949859,47949859,2.198746475,1997,spawn1997
308,dantes peak,115000000,67163857,178200000,63200000,1.5495652173913044,1997,dantes peak1997
337,speed 2 cruise control,110000000,48097081,150468000,40468000,1.367890909090909,1997,speed 2 cruise control1997
1147,the peacemaker,50000000,41263140,62967368,12967368,1.25934736,1997,the peacemaker1997
1135,absolute power,50000000,50068310,50068310,68310,1.0013662,1997,absolute power1997
729,seven years in tibet,70000000,37945884,131445884,61445884,1.8777983428571428,1997,seven years in tibet1997
707,hercules,70000000,99112101,250700000,180700000,3.5814285714285714,1997,hercules1997
1617,gattaca,36000000,12532777,12532777,-23467223,0.34813269444444445,1997,gattaca1997
1191,mad city,50000000,10561038,10561038,-39438962,0.21122076,1997,mad city1997
2078,kundun,28000000,5686694,5686694,-22313306,0.20309621428571428,1997,kundun1997
3332,oscar and lucinda,12500000,1612957,1612957,-10887043,0.12903656,1997,oscar and lucinda1997
630,the lost world jurassic park,75000000,229086679,618638999,543638999,8.248519986666667,1997,the lost world jurassic park1997
4906,smoke signals,2000000,6719300,7756617,5756617,3.8783085,1998,smoke signals1998
780,youve got mail,65000000,115821495,250800000,185800000,3.8584615384615386,1998,youve got mail1998
1729,knock off,35000000,10319915,10319915,-24680085,0.2948547142857143,1998,knock off1998
4140,mr nice guy,6000000,12716953,31716953,25716953,5.286158833333333,1998,mr nice guy1998
2875,halloween h2o,17000000,55041738,55041738,38041738,3.237749294117647,1998,halloween h2o1998
4944,clockwatchers,2000000,537948,539961,-1460039,0.2699805,1998,clockwatchers1998
1428,small soldiers,40000000,55143823,71743823,31743823,1.793595575,1998,small soldiers1998
738,hard rain,70000000,19870567,19870567,-50129433,0.2838652428571429,1998,hard rain1998
1102,stepmom,50000000,91137662,159745279,109745279,3.19490558,1998,stepmom1998
4332,slums of beverly hills,5000000,5502773,5502773,502773,1.1005546,1998,slums of beverly hills1998
2544,how stella got her groove back,20000000,37672944,37672944,17672944,1.8836472,1998,how stella got her groove back1998
2405,theres something about mary,22000000,176484651,369884651,347884651,16.81293868181818,1998,theres something about mary1998
3380,rounders,12000000,22921898,22921898,10921898,1.9101581666666667,1998,rounders1998
2122,shakespeare in love,26000000,100317794,279500000,253500000,10.75,1998,shakespeare in love1998
2587,psycho,20000000,21541218,37226218,17226218,1.8613109,1998,psycho1998
943,holy man,60000000,12069719,12069719,-47930281,0.20116198333333332,1998,holy man1998
1157,jack frost,50000000,34645374,34645374,-15354626,0.69290748,1998,jack frost1998
583,what dreams may come,80000000,55485043,71485043,-8514957,0.8935630375,1998,what dreams may come1998
2342,i still know what you did last summer,24000000,40020622,40020622,16020622,1.6675259166666667,1998,i still know what you did last summer1998
2248,he got game,25000000,21567853,22411948,-2588052,0.89647792,1998,he got game1998
5684,the mighty,100000,2652246,6121582,6021582,61.21582,1998,the mighty1998
3415,celebrity,12000000,5078660,6200000,-5800000,0.5166666666666667,1998,celebrity1998
2591,vampires,20000000,20268825,20268825,268825,1.01344125,1998,vampires1998
690,doctor dolittle,71500000,144156605,294156605,222656605,4.114078391608391,1998,doctor dolittle1998
872,the horse whisperer,60000000,75383563,186883563,126883563,3.11472605,1998,the horse whisperer1998
5554,first love last rites,300000,10876,10876,-289124,0.03625333333333333,1998,first love last rites1998
4776,central do brasil,2900000,5969553,17006158,14106158,5.864192413793104,1998,central do brasil1998
1653,the man in the iron mask,35000000,56968169,56968169,21968169,1.6276619714285714,1998,the man in the iron mask1998
3052,the object of my affection,15000000,29145924,29145924,14145924,1.9430616,1998,the object of my affection1998
1252,a bugs life,45000000,162798565,363095319,318095319,8.068784866666666,1998,a bugs life1998
5252,slam,1000000,1009819,1087521,87521,1.087521,1998,slam1998
2022,the borrowers,29000000,22619589,54045832,25045832,1.8636493793103448,1998,the borrowers1998
3724,an alan smithee film burn hollywood burn,10000000,45779,45779,-9954221,0.0045779,1998,an alan smithee film burn hollywood burn1998
584,mighty joe young,80000000,50632037,50632037,-29367963,0.6329004625,1998,mighty joe young1998
2109,the newton boys,27000000,10341093,10341093,-16658907,0.38300344444444445,1998,the newton boys1998
2885,a night at the roxbury,17000000,30331165,30331165,13331165,1.7841861764705882,1998,a night at the roxbury1998
3183,urban legend,14000000,38116707,72571864,58571864,5.183704571428572,1998,urban legend1998
3458,madadayo,11900000,48856,48856,-11851144,0.004105546218487395,1998,madadayo1998
502,enemy of the state,85000000,111549836,250649836,165649836,2.9488216,1998,enemy of the state1998
448,mulan,90000000,120620254,303500000,213500000,3.3722222222222222,1998,mulan1998
4142,sliding doors,6000000,11911200,58809149,52809149,9.801524833333334,1998,sliding doors1998
2232,elizabeth,25000000,30082699,82150642,57150642,3.28602568,1998,elizabeth1998
934,the avengers,60000000,23385416,48585416,-11414584,0.8097569333333333,1998,the avengers1998
3029,the faculty,15000000,40283321,40283321,25283321,2.6855547333333334,1998,the faculty1998
4725,happiness,3000000,2746453,5746453,2746453,1.9154843333333333,1998,happiness1998
5707,i love you â dont touch me,68000,33598,33598,-34402,0.49408823529411766,1998,i love you â dont touch me1998
3200,dead man on campus,14000000,15064948,15064948,1064948,1.0760677142857142,1998,dead man on campus1998
5398,hav plenty,650000,2301777,2301777,1651777,3.5411953846153845,1998,hav plenty1998
1879,hope floats,30000000,60110313,81529000,51529000,2.717633333333333,1998,hope floats1998
4951,sixstring samurai,2000000,134624,134624,-1865376,0.067312,1998,sixstring samurai1998
1143,the negotiator,50000000,44705766,49105766,-894234,0.98211532,1998,the negotiator1998
4354,zero effect,5000000,2080693,2080693,-2919307,0.4161386,1998,zero effect1998
1316,deep rising,45000000,11203026,11203026,-33796974,0.24895613333333333,1998,deep rising1998
1064,beloved,53000000,22852487,22852487,-30147513,0.431179,1998,beloved1998
4861,dancer texas pop 81,2300000,574838,574838,-1725162,0.2499295652173913,1998,dancer texas pop 811998
3706,la femme de chambre du titanic,10000000,244465,244465,-9755535,0.0244465,1998,la femme de chambre du titanic1998
2234,spice world,25000000,29342592,56042592,31042592,2.24170368,1998,spice world1998
2893,a simple plan,17000000,16316273,16316273,-683727,0.9597807647058824,1998,a simple plan1998
804,primary colors,65000000,39017984,39017984,-25982016,0.600276676923077,1998,primary colors1998
602,babe pig in the city,80000000,18319860,69131860,-10868140,0.86414825,1998,babe pig in the city1998
1490,quest for camelot,40000000,22772500,38172500,-1827500,0.9543125,1998,quest for camelot1998
4280,the players club,5000000,23047939,23047939,18047939,4.6095878,1998,the players club1998
1089,patch adams,50000000,135014968,202173000,152173000,4.04346,1998,patch adams1998
1072,the thin red line,52000000,36400491,97709034,45709034,1.8790198846153847,1998,the thin red line1998
2619,twilight,20000000,15055091,15055091,-4944909,0.75275455,1998,twilight1998
3807,velvet goldmine,9000000,1053788,4313644,-4686356,0.47929377777777776,1998,velvet goldmine1998
4157,little voice,6000000,4595000,21787233,15787233,3.6312055,1998,little voice1998
726,the siege,70000000,40934175,116625798,46625798,1.6660828285714286,1998,the siege1998
1953,the replacement killers,30000000,19035741,19035741,-10964259,0.6345247,1998,the replacement killers1998
2516,la vita ã bella,20000000,57598247,229385361,209385361,11.46926805,1998,la vita ã bella1998
768,the x files fight the future,66000000,83898313,189176423,123176423,2.8663094393939392,1998,the x files fight the future1998
2568,wild things,20000000,29795299,55576699,35576699,2.77883495,1998,wild things1998
5706,pi,68000,3221152,4678513,4610513,68.80166176470588,1998,pi1998
5245,two girls and a guy,1000000,2057193,2315026,1315026,2.315026,1998,two girls and a guy1998
3266,the big hit,13000000,27066941,27066941,14066941,2.0820723846153846,1998,the big hit1998
3284,dirty work,13000000,10020081,10020081,-2979919,0.7707754615384615,1998,dirty work1998
2315,without limits,25000000,780326,780326,-24219674,0.03121304,1998,without limits1998
770,saving private ryan,65000000,216335085,485035085,420035085,7.46207823076923,1998,saving private ryan1998
5545,lets talk about sex,300000,373615,373615,73615,1.2453833333333333,1998,lets talk about sex1998
4369,no looking back,5000000,143273,143273,-4856727,0.0286546,1998,no looking back1998
4603,i got the hookup,3500000,10317779,10317779,6817779,2.947936857142857,1998,i got the hookup1998
2368,the waterboy,23000000,161491646,190191646,167191646,8.269202,1998,the waterboy1998
2126,ever after a cinderella story,26000000,65705772,65705772,39705772,2.5271450769230768,1998,ever after a cinderella story1998
207,armageddon,140000000,201578182,554600000,414600000,3.9614285714285713,1998,armageddon1998
4606,gods and monsters,3500000,6451628,6451628,2951628,1.8433222857142857,1998,gods and monsters1998
920,mercury rising,60000000,32983332,32983332,-27016668,0.5497222,1998,mercury rising1998
2227,bride of chucky,25000000,32404188,50692188,25692188,2.02768752,1998,bride of chucky1998
5285,safe men,1000000,21210,21210,-978790,0.02121,1998,safe men1998
3096,home fries,15000000,10513979,10513979,-4486021,0.7009319333333334,1998,home fries1998
5260,orgazmo,1000000,582024,627287,-372713,0.627287,1998,orgazmo1998
4955,24 7 twenty four seven,2000000,72544,72544,-1927456,0.036272,1998,24 7 twenty four seven1998
3398,living out loud,12000000,12905901,12905901,905901,1.07549175,1998,living out loud1998
3634,the spanish prisoner,10000000,10162034,13835130,3835130,1.383513,1998,the spanish prisoner1998
5284,the last big thing,1000000,22434,22434,-977566,0.022434,1998,the last big thing1998
2760,fear and loathing in las vegas,18500000,10680275,13711903,-4788097,0.7411839459459459,1998,fear and loathing in las vegas1998
886,a civil action,60000000,56709981,56709981,-3290019,0.94516635,1998,a civil action1998
4440,karakter,4500000,713413,713413,-3786587,0.15853622222222222,1998,karakter1998
515,meet joe black,85000000,44650003,44650003,-40349997,0.5252941529411764,1998,meet joe black1998
902,practical magic,60000000,46850558,68336997,8336997,1.13894995,1998,practical magic1998
1630,rush hour,35000000,141186864,245300000,210300000,7.008571428571429,1998,rush hour1998
5132,festen,1300000,1647780,1647780,347780,1.267523076923077,1998,festen1998
4054,chairman of the board,7000000,306715,306715,-6693285,0.04381642857142857,1998,chairman of the board1998
4531,shooting fish,4000000,302204,302204,-3697796,0.075551,1998,shooting fish1998
5445,hurricane streets,500000,334041,367582,-132418,0.735164,1998,hurricane streets1998
3073,disturbing behavior,15000000,17507368,19014238,4014238,1.2676158666666666,1998,disturbing behavior1998
1003,city of angels,55000000,78750909,198750909,143750909,3.613652890909091,1998,city of angels1998
3074,the big lebowski,15000000,17498804,46189568,31189568,3.0793045333333335,1998,the big lebowski1998
3594,cant hardly wait,10000000,25358996,25358996,15358996,2.5358996,1998,cant hardly wait1998
5579,i married a strange person,250000,203134,203134,-46866,0.812536,1998,i married a strange person1998
786,the mask of zorro,65000000,93828745,233700000,168700000,3.5953846153846154,1998,the mask of zorro1998
3910,clay pigeons,8000000,1793359,2256606,-5743394,0.28207575,1998,clay pigeons1998
2601,simon birch,20000000,18253415,18310591,-1689409,0.91552955,1998,simon birch1998
3094,barneys great adventure,15000000,11156471,11156471,-3843529,0.7437647333333334,1998,barneys great adventure1998
2746,firestorm,19000000,8123860,8123860,-10876140,0.4275715789473684,1998,firestorm1998
2362,meet the deedles,24000000,4356126,4356126,-19643874,0.18150525,1998,meet the deedles1998
3278,54,13000000,16757163,16757163,3757163,1.2890125384615385,1998,541998
677,snake eyes,73000000,55591409,103891409,30891409,1.4231699863013698,1998,snake eyes1998
3286,woo,13000000,8064972,8064972,-4935028,0.6203824615384615,1998,woo1998
2104,dark city,27000000,14435076,27257061,257061,1.0095207777777777,1998,dark city1998
5239,next stop wonderland,1000000,3395581,3465703,2465703,3.465703,1998,next stop wonderland1998
1939,bulworth,30000000,26528684,29203383,-796617,0.9734461,1998,bulworth1998
1943,one true thing,30000000,23337196,26708196,-3291804,0.8902732,1998,one true thing1998
667,soldier,75000000,14623082,14623082,-60376918,0.19497442666666667,1998,soldier1998
848,the truman show,60000000,125618201,264118201,204118201,4.401970016666667,1998,the truman show1998
4798,the dress,2650000,16556,16556,-2633444,0.00624754716981132,1998,the dress1998
860,antz,60000000,90757863,152457863,92457863,2.5409643833333333,1998,antz1998
273,godzilla,125000000,136314294,376000000,251000000,3.008,1998,godzilla1998
5078,buffalo 66,1500000,2380606,2380606,880606,1.5870706666666667,1998,buffalo 661998
3652,american history x,10000000,6719864,6719864,-3280136,0.6719864,1998,american history x1998
573,six days seven nights,80000000,74339294,164800000,84800000,2.06,1998,six days seven nights1998
856,the prince of egypt,60000000,101413188,218613188,158613188,3.6435531333333335,1998,the prince of egypt1998
4474,love and death on long island,4030000,2542264,2542264,-1487736,0.6308347394540943,1998,love and death on long island1998
3611,rushmore,10000000,17105219,19080435,9080435,1.9080435,1998,rushmore1998
1270,blade,45000000,70141876,131237688,86237688,2.9163930666666666,1998,blade1998
577,lost in space,80000000,69117629,136047317,56047317,1.7005914625,1998,lost in space1998
678,sphere,73000000,37068294,50168294,-22831706,0.687236904109589,1998,sphere1998
3636,very bad things,10000000,9949470,21094974,11094974,2.1094974,1998,very bad things1998
3888,half baked,8000000,17394881,17394881,9394881,2.174360125,1998,half baked1998
4694,belly,3000000,9639390,9639390,6639390,3.21313,1998,belly1998
715,star trek insurrection,70000000,70187658,117800000,47800000,1.6828571428571428,1998,star trek insurrection1998
3605,jane austens mafia,10000000,19843795,30143795,20143795,3.0143795,1998,jane austens mafia1998
3925,the land girls,8000000,146083,146083,-7853917,0.018260375,1998,the land girls1998
211,lethal weapon 4,140000000,130444603,285400000,145400000,2.0385714285714287,1998,lethal weapon 41998
1022,ronin,55000000,41610884,70692101,15692101,1.2853109272727272,1998,ronin1998
2703,les couloirs du temps les visiteurs 2,20000000,146072,26146072,6146072,1.3073036,1998,les couloirs du temps les visiteurs 21998
5577,cube,250000,489220,8969065,8719065,35.87626,1998,cube1998
546,deep impact,80000000,140464664,349464664,269464664,4.3683083,1998,deep impact1998
4672,waking ned devine,3000000,24793251,55193251,52193251,18.397750333333335,1998,waking ned devine1998
2036,the rugrats movie,28000000,100494685,140894685,112894685,5.031953035714285,1998,the rugrats movie1998
1228,out of sight,48000000,37562568,77562568,29562568,1.6158868333333334,1998,out of sight1998
3123,idle hands,15000000,4023741,4023741,-10976259,0.2682494,1999,idle hands1999
3132,crazy in alabama,15000000,1954202,1954202,-13045798,0.13028013333333333,1999,crazy in alabama1999
4288,dougs 1st movie,5000000,19421271,19421271,14421271,3.8842542,1999,dougs 1st movie1999
3109,the love letter,15000000,8322608,9010980,-5989020,0.600732,1999,the love letter1999
2896,the adventures of elmo in grouchland,17000000,11634458,11634458,-5365542,0.6843798823529412,1999,the adventures of elmo in grouchland1999
3137,felicias journey,15000000,824295,1970268,-13029732,0.1313512,1999,felicias journey1999
936,edtv,60000000,22508689,35319689,-24680311,0.5886614833333333,1999,edtv1999
1009,bowfinger,55000000,66458769,98699769,43699769,1.7945412545454547,1999,bowfinger1999
439,toy story 2,90000000,245852179,511358276,421358276,5.6817586222222225,1999,toy story 21999
4937,get real,2000000,1152411,1152411,-847589,0.5762055,1999,get real1999
4373,desert blue,5000000,99147,99147,-4900853,0.0198294,1999,desert blue1999
915,my favorite martian,60000000,36850101,36850101,-23149899,0.61416835,1999,my favorite martian1999
3093,the muse,15000000,11614954,11614954,-3385046,0.7743302666666667,1999,the muse1999
1028,instinct,55000000,34105207,34105207,-20894793,0.6200946727272727,1999,instinct1999
2845,one mans hero,18000000,229311,229311,-17770689,0.0127395,1999,one mans hero1999
3188,superstar,14000000,30628981,30628981,16628981,2.1877843571428572,1999,superstar1999
1975,wing commander,30000000,11578022,11578022,-18421978,0.3859340666666667,1999,wing commander1999
4204,stiff upper lips,5700000,69582,69582,-5630418,0.012207368421052632,1999,stiff upper lips1999
1990,gloria,30000000,4167493,4967493,-25032507,0.1655831,1999,gloria1999
3120,jakob the liar,15000000,4956401,4956401,-10043599,0.33042673333333333,1999,jakob the liar1999
2274,angelas ashes,25000000,13038660,13038660,-11961340,0.5215464,1999,angelas ashes1999
4897,boys dont cry,2000000,11540607,20741000,18741000,10.3705,1999,boys dont cry1999
3201,tea with mussolini,14000000,14395874,14395874,395874,1.0282767142857143,1999,tea with mussolini1999
576,fantasia 2000 theatrical release,80000000,69610858,69618634,-10381366,0.870232925,1999,fantasia 2000 theatrical release1999
805,fight club,65000000,37030102,100851705,35851705,1.5515646923076922,1999,fight club1999
348,stuart little,105000000,140015224,298815224,193815224,2.845859276190476,1999,stuart little1999
4516,love stinks,4000000,2793776,2793776,-1206224,0.698444,1999,love stinks1999
796,eyes wide shut,65000000,55691208,104267443,39267443,1.6041145076923078,1999,eyes wide shut1999
1156,for love of the game,50000000,35188640,46112640,-3887360,0.9222528,1999,for love of the game1999
4527,the loss of sexual innocence,4000000,399793,399793,-3600207,0.09994825,1999,the loss of sexual innocence1999
2288,brokedown palace,25000000,10115014,11115766,-13884234,0.44463064,1999,brokedown palace1999
1166,the story of us,50000000,27100030,27100030,-22899970,0.5420006,1999,the story of us1999
4093,bats,6500000,10155691,10155691,3655691,1.562414,1999,bats1999
2771,deuce bigalow male gigolo,18000000,65535067,92935067,74935067,5.163059277777778,1999,deuce bigalow male gigolo1999
1175,the iron giant,50000000,23159305,31333917,-18666083,0.62667834,1999,the iron giant1999
4090,go,6500000,16875273,28383441,21883441,4.3666832307692305,1999,go1999
1857,pokemon the first movie,30000000,85744662,163644662,133644662,5.454822066666667,1999,pokemon the first movie1999
855,the generals daughter,60000000,102705852,149705852,89705852,2.4950975333333334,1999,the generals daughter1999
5129,lock stock and two smoking barrels,1350000,3897569,28356188,27006188,21.004583703703705,1999,lock stock and two smoking barrels1999
2030,mumford,28700000,4559569,4559569,-24140431,0.15887,1999,mumford1999
3214,a walk on the moon,14000000,4741987,4741987,-9258013,0.33871335714285716,1999,a walk on the moon1999
1974,in dreams,30000000,12017369,12017369,-17982631,0.40057896666666665,1999,in dreams1999
1073,man on the moon,52000000,34580635,47407635,-4592365,0.9116852884615385,1999,man on the moon1999
3262,10 things i hate about you,13000000,38177966,60413950,47413950,4.647226923076923,1999,10 things i hate about you1999
3210,lost and found,14000000,6552255,6552255,-7447745,0.4680182142857143,1999,lost and found1999
4695,trippinâ,3000000,9017070,9017070,6017070,3.00569,1999,trippinâ1999
4623,taxman,3500000,9871,9871,-3490129,0.0028202857142857144,1999,taxman1999
4721,jawbreaker,3000000,3076820,3076820,76820,1.0256066666666668,1999,jawbreaker1999
1268,galaxy quest,45000000,71423726,90523726,45523726,2.0116383555555557,1999,galaxy quest1999
696,runaway bride,70000000,152257509,310138178,240138178,4.4305454,1999,runaway bride1999
2997,american beauty,15000000,130058047,356258047,341258047,23.750536466666667,1999,american beauty1999
767,entrapment,66000000,87707396,211700000,145700000,3.2075757575757575,1999,entrapment1999
1851,analyze this,30000000,106885658,176885658,146885658,5.8961886,1999,analyze this1999
4651,dreaming of joseph lees,3250000,7680,7680,-3242320,0.002363076923076923,1999,dreaming of joseph lees1999
760,the insider,68000000,28965197,60265197,-7734803,0.8862528970588235,1999,the insider1999
822,random hearts,64000000,31054924,63200000,-800000,0.9875,1999,random hearts1999
4038,a dog of flanders,7000000,2165637,2165637,-4834363,0.3093767142857143,1999,a dog of flanders1999
1816,cradle will rock,32000000,2899970,2899970,-29100030,0.0906240625,1999,cradle will rock1999
759,mystery men,68000000,29762011,33462011,-34537989,0.4920883970588235,1999,mystery men1999
2100,lake placid,27000000,31770413,31770413,4770413,1.176681962962963,1999,lake placid1999
659,anna and the king,75000000,39251128,39251128,-35748872,0.5233483733333333,1999,anna and the king1999
2967,detroit rock city,16000000,4217115,5825314,-10174686,0.364082125,1999,detroit rock city1999
775,the matrix,65000000,171479930,463517383,398517383,7.131036661538461,1999,the matrix1999
4545,the velocity of gary,4000000,34145,34145,-3965855,0.00853625,1999,the velocity of gary1999
705,sleepy hollow,70000000,101068340,207068340,137068340,2.958119142857143,1999,sleepy hollow1999
4017,in too deep,7000000,14026509,15471229,8471229,2.2101755714285716,1999,in too deep1999
4027,outside providence,7000000,7309628,7824358,824358,1.1177654285714285,1999,outside providence1999
2734,house on haunted hill,19000000,40846082,65090541,46090541,3.425817947368421,1999,house on haunted hill1999
875,deep blue sea,60000000,73648228,165048228,105048228,2.7508038,1999,deep blue sea1999
385,end of days,100000000,66889043,212026975,112026975,2.12026975,1999,end of days1999
871,any given sunday,60000000,75530832,100230832,40230832,1.6705138666666666,1999,any given sunday1999
4159,simply irresistible,6000000,4398989,4398989,-1601011,0.7331648333333334,1999,simply irresistible1999
1188,the messenger the story of joan of arc,50000000,14271297,14271297,-35728703,0.28542594,1999,the messenger the story of joan of arc1999
470,bicentennial man,90000000,58220776,87420776,-2579224,0.9713419555555556,1999,bicentennial man1999
4544,among giants,4000000,64359,64359,-3935641,0.01608975,1999,among giants1999
303,star wars ep i the phantom menace,115000000,474544677,1027044677,912044677,8.930823278260869,1999,star wars ep i the phantom menace1999
650,life,75000000,64062587,73521587,-1478413,0.9802878266666667,1999,life1999
4436,tango,4500000,1687311,5428387,928387,1.2063082222222221,1999,tango1999
2074,mystery alaska,28000000,8891623,8891623,-19108377,0.3175579642857143,1999,mystery alaska1999
3272,being john malkovich,13000000,22858926,32382381,19382381,2.4909523846153845,1999,being john malkovich1999
643,inspector gadget,75000000,97387965,97387965,22387965,1.2985062,1999,inspector gadget1999
1218,the thomas crown affair,48000000,69304264,124304264,76304264,2.589672166666667,1999,the thomas crown affair1999
1220,the bone collector,48000000,66488090,151463090,103463090,3.1554810416666665,1999,the bone collector1999
1221,three kings,48000000,60652036,107752036,59752036,2.244834083333333,1999,three kings1999
2960,the thirteenth floor,16000000,11810854,11810854,-4189146,0.738178375,1999,the thirteenth floor1999
1839,big daddy,30000000,163479795,228641283,198641283,7.6213761,1999,big daddy1999
3265,baby geniuses,13000000,27151490,27151490,14151490,2.088576153846154,1999,baby geniuses1999
281,the 13th warrior,125000000,32698899,61698899,-63301101,0.493591192,1999,the 13th warrior1999
2113,flawless,27000000,4485485,4485485,-22514515,0.16612907407407407,1999,flawless1999
5058,mississippi mermaid,1600000,27795,2627795,1027795,1.642371875,1999,mississippi mermaid1999
4749,the gambler,3000000,51773,101773,-2898227,0.033924333333333334,1999,the gambler1999
2931,varsity blues,16000000,52894169,54294169,38294169,3.3933855625,1999,varsity blues1999
5294,sparkler,1000000,5494,5494,-994506,0.005494,1999,sparkler1999
5778,following,6000,48482,240495,234495,40.0825,1999,following1999
3477,cruel intentions,11000000,38665260,76238901,65238901,6.930809181818182,1999,cruel intentions1999
2358,play it to the bone,24000000,8427204,8427204,-15572796,0.3511335,1999,play it to the bone1999
3635,le violon rouge,10000000,10019109,10019109,19109,1.0019109,1999,le violon rouge1999
5526,trekkies,375000,617172,617172,242172,1.645792,1999,trekkies1999
1627,austin powers the spy who shagged me,35000000,206040085,312383487,277383487,8.925242485714286,1999,austin powers the spy who shagged me1999
1385,double jeopardy,40000000,116735231,177835231,137835231,4.445880775,1999,double jeopardy1999
5743,pink narcissus,27000,8231,8231,-18769,0.3048518518518519,1999,pink narcissus1999
5581,sugar town,250000,178095,178095,-71905,0.71238,1999,sugar town1999
1515,universal soldier ii the return,40000000,10447421,10717421,-29282579,0.267935525,1999,universal soldier ii the return1999
3886,drive me crazy,8000000,17843379,22591451,14591451,2.823931375,1999,drive me crazy1999
3522,an ideal husband,10700000,18542974,31341183,20641183,2.929082523364486,1999,an ideal husband1999
2473,the bachelor,21000000,21731001,36882378,15882378,1.7563037142857143,1999,the bachelor1999
5539,tumbleweeds,312000,1350248,1788168,1476168,5.731307692307692,1999,tumbleweeds1999
2642,three to tango,20000000,10570375,10570375,-9429625,0.52851875,1999,three to tango1999
199,tarzan,145000000,171091819,448191819,303191819,3.0909780620689653,1999,tarzan1999
1615,snow falling on cedars,36000000,14378353,14378353,-21621647,0.3993986944444444,1999,snow falling on cedars1999
2474,the rage carrie 2,21000000,17760244,17760244,-3239756,0.8457259047619048,1999,the rage carrie 21999
2682,mononokehime,20000000,2374107,150350000,130350000,7.5175,1999,mononokehime1999
106,wild wild west,175000000,113805681,221229335,46229335,1.2641676285714285,1999,wild wild west1999
3578,dogma,10000000,30651422,43948865,33948865,4.3948865,1999,dogma1999
3289,dick,13000000,6276869,6276869,-6723131,0.4828360769230769,1999,dick1999
4126,the wood,6000000,25059640,25059640,19059640,4.176606666666666,1999,the wood1999
1479,the outoftowners,40000000,28544120,28544120,-11455880,0.713603,1999,the outoftowners1999
3426,ravenous,12000000,2062406,2062406,-9937594,0.17186716666666665,1999,ravenous1999
3619,the corruptor,10000000,15164492,15164492,5164492,1.5164492,1999,the corruptor1999
5413,broken vessels,600000,15030,85343,-514657,0.14223833333333333,1999,broken vessels1999
1764,chill factor,34000000,11263966,11263966,-22736034,0.3312931176470588,1999,chill factor1999
2431,summer of sam,22000000,19288130,19288130,-2711870,0.8767331818181818,1999,summer of sam1999
1698,blast from the past,35000000,26613620,26613620,-8386380,0.7603891428571429,1999,blast from the past1999
3775,the best man,9000000,34102780,34572780,25572780,3.84142,1999,the best man1999
5708,20 dates,66000,541636,602920,536920,9.135151515151515,1999,20 dates1999
5643,bachehaye aseman,180000,933933,1628579,1448579,9.047661111111111,1999,bachehaye aseman1999
5436,beyond the mat,500000,2047570,2047570,1547570,4.09514,1999,beyond the mat1999
1601,magnolia,37000000,22450975,48446802,11446802,1.309373027027027,1999,magnolia1999
2442,dudley doright,22000000,9818792,9818792,-12181208,0.44630872727272725,1999,dudley doright1999
3545,shes all that,10000000,63465522,63465522,53465522,6.3465522,1999,shes all that1999
3290,light it up,13000000,5871603,5871603,-7128397,0.45166176923076923,1999,light it up1999
1811,bringing out the dead,32000000,16640210,16640210,-15359790,0.5200065625,1999,bringing out the dead1999
1751,ride with the devil,35000000,630779,630779,-34369221,0.018022257142857143,1999,ride with the devil1999
2461,south park bigger longer  uncut,21000000,52037603,52037603,31037603,2.4779810952380954,1999,south park bigger longer  uncut1999
5442,twin falls idaho,500000,985341,1027228,527228,2.054456,1999,twin falls idaho1999
1779,pushing tin,33000000,8408835,8408835,-24591165,0.2548131818181818,1999,pushing tin1999
3697,illuminata,10000000,836641,836641,-9163359,0.0836641,1999,illuminata1999
1374,the sixth sense,40000000,293506292,672806292,632806292,16.8201573,1999,the sixth sense1999
1492,at first sight,40000000,22365133,22365133,-17634867,0.559128325,1999,at first sight1999
1344,notting hill,42000000,116089678,363728085,321728085,8.6601925,1999,notting hill1999
2665,topsy turvy,20000000,6201757,6201757,-13798243,0.31008785,1999,topsy turvy1999
1564,the hurricane,38000000,50699241,73956241,35956241,1.9462168684210526,1999,the hurricane1999
3672,the limey,10000000,3193102,6030047,-3969953,0.6030047,1999,the limey1999
2455,arlington road,21500000,24419219,24419219,2919219,1.1357776279069767,1999,arlington road1999
2355,muppets from space,24000000,16304786,16304786,-7695214,0.6793660833333334,1999,muppets from space1999
668,virus,75000000,14010690,30626690,-44373310,0.4083558666666667,1999,virus1999
3983,the omega code,7200000,12610552,12678312,5478312,1.7608766666666666,1999,the omega code1999
4150,200 cigarettes,6000000,6852450,6852450,852450,1.142075,1999,200 cigarettes1999
543,the mummy,80000000,155385488,416385488,336385488,5.2048186,1999,the mummy1999
5034,lola rennt,1750000,7267324,22879194,21129194,13.073825142857142,1999,lola rennt1999
847,the green mile,60000000,136801374,290701374,230701374,4.8450229,1999,the green mile1999
1109,payback,50000000,81526121,161626121,111626121,3.23252242,1999,payback1999
5043,happy texas,1700000,2039192,2891228,1191228,1.7007223529411766,1999,happy texas1999
1890,message in a bottle,30000000,52880016,52880016,22880016,1.7626672,1999,message in a bottle1999
565,the haunting,80000000,91188905,180188905,100188905,2.2523613125,1999,the haunting1999
3343,american pie,12000000,101800948,234723148,222723148,19.560262333333334,1999,american pie1999
5050,foolish,1600000,6026908,6026908,4426908,3.7668175,1999,foolish1999
2383,anywhere but here,23000000,18653615,18653615,-4346385,0.8110267391304348,1999,anywhere but here1999
3840,election,8500000,14943582,17202854,8702854,2.023865176470588,1999,election1999
2391,the end of the affair,23000000,10660147,10660147,-12339853,0.46348465217391305,1999,the end of the affair1999
3654,the straight story,10000000,6197866,6197866,-3802134,0.6197866,1999,the straight story1999
1510,the deep end of the ocean,40000000,13508635,13508635,-26491365,0.337715875,1999,the deep end of the ocean1999
1460,8mm,40000000,36443442,96398826,56398826,2.40997065,1999,8mm1999
5589,the sticky fingers of time,250000,18195,20628,-229372,0.082512,1999,the sticky fingers of time1999
1765,the astronauts wife,34000000,10672566,10672566,-23327434,0.313899,1999,the astronauts wife1999
3442,breakfast of champions,12000000,178287,178287,-11821713,0.01485725,1999,breakfast of champions1999
3854,limbo,8300000,2160710,2598224,-5701776,0.3130390361445783,1999,limbo1999
1796,stigmata,32000000,50041732,89441732,57441732,2.795054125,1999,stigmata1999
227,the world is not enough,135000000,126930660,361730660,226730660,2.67948637037037,1999,the world is not enough1999
3457,diamonds,11900000,81897,81897,-11818103,0.006882100840336134,1999,diamonds1999
5393,naturally native,700000,10508,10508,-689492,0.015011428571428571,1999,naturally native1999
5406,the blair witch project,600000,140539099,248300000,247700000,413.8333333333333,1999,the blair witch project1999
3385,stir of echoes,12000000,21133087,21133087,9133087,1.7610905833333332,1999,stir of echoes1999
2482,existenz,20700000,2840417,2840417,-17859583,0.13721821256038647,1999,existenz1999
1607,blue streak,36000000,68208190,117448157,81448157,3.2624488055555556,1999,blue streak1999
1464,mickey blue eyes,40000000,33864342,53864342,13864342,1.34660855,1999,mickey blue eyes1999
1404,the talented mr ripley,40000000,81292135,128792135,88792135,3.219803375,1999,the talented mr ripley1999
3632,drop dead gorgeous,10000000,10571408,10571408,571408,1.0571408,1999,drop dead gorgeous1999
2480,molly,21000000,17396,17396,-20982604,0.0008283809523809524,1999,molly1999
3631,office space,10000000,10827813,12179708,2179708,1.2179708,1999,office space1999
2349,girl interrupted,24000000,28871190,28871190,4871190,1.20296625,1999,girl interrupted1999
3308,the claim,13000000,622023,1375635,-11624365,0.10581807692307692,2000,the claim2000
1863,rugrats in paris,30000000,76501438,103284813,73284813,3.4428271,2000,rugrats in paris2000
324,the patriot,110000000,113330342,215300000,105300000,1.9572727272727273,2000,the patriot2000
3258,dude wheres my car,13000000,46729374,73180297,60180297,5.6292536153846155,2000,dude wheres my car2000
5268,luminarias,1000000,428535,428535,-571465,0.428535,2000,luminarias2000
4076,aimãe  jaguar,6800000,927107,927107,-5872893,0.13633926470588234,2000,aimãe  jaguar2000
3891,american psycho,8000000,15070285,34270285,26270285,4.283785625,2000,american psycho2000
5288,the specials,1000000,12996,12996,-987004,0.012996,2000,the specials2000
1345,chicken run,42000000,106793915,227793915,185793915,5.423664642857143,2000,chicken run2000
4669,the original kings of comedy,3000000,38168022,38236338,35236338,12.745446,2000,the original kings of comedy2000
2350,nurse betty,24000000,25170054,27732366,3732366,1.15551525,2000,nurse betty2000
1150,the beach,50000000,39778599,39778599,-10221401,0.79557198,2000,the beach2000
1845,remember the titans,30000000,115654751,136706683,106706683,4.556889433333334,2000,remember the titans2000
1142,the replacements,50000000,44737059,50054511,54511,1.00109022,2000,the replacements2000
3902,woman on top,8000000,5018450,10192613,2192613,1.274076625,2000,woman on top2000
2373,final destination,23000000,53302314,112036870,89036870,4.871168260869565,2000,final destination2000
5136,the basket,1300000,609042,609042,-690958,0.46849384615384615,2000,the basket2000
3903,held up,8000000,4714090,4714090,-3285910,0.58926125,2000,held up2000
354,gone in 60 seconds,103300000,101643008,232643008,129343008,2.252110435624395,2000,gone in 60 seconds2000
2356,ready to rumble,24000000,12372410,12372410,-11627590,0.5155170833333333,2000,ready to rumble2000
1776,the watcher,33000000,28946615,47267829,14267829,1.4323584545454546,2000,the watcher2000
4060,the boondock saints,7000000,30471,411874,-6588126,0.058839142857142854,2000,the boondock saints2000
1227,bedazzled,48000000,37879996,90376224,42376224,1.882838,2000,bedazzled2000
3330,dancer in the dark,12500000,4157491,45557491,33057491,3.64459928,2000,dancer in the dark2000
3250,snow day,13000000,60008303,62452927,49452927,4.804071307692308,2000,snow day2000
1770,big mommas house,33000000,117559438,173559438,140559438,5.259376909090909,2000,big mommas house2000
1397,scream 3,40000000,89138076,161838076,121838076,4.0459519,2000,scream 32000
5160,you can count on me,1200000,9180275,10827356,9627356,9.022796666666666,2000,you can count on me2000
5258,fiza,1000000,623791,1179462,179462,1.179462,2000,fiza2000
2387,the crew,23000000,13019253,13019253,-9980747,0.5660544782608695,2000,the crew2000
4131,best in show,6000000,18621249,20695413,14695413,3.4492355,2000,best in show2000
379,the emperors new groove,100000000,89296573,169296573,69296573,1.69296573,2000,the emperors new groove2000
284,the perfect storm,120000000,182618434,328711434,208711434,2.73926195,2000,the perfect storm2000
1200,what planet are you from,50000000,6291602,6291602,-43708398,0.12583204,2000,what planet are you from2000
2806,small time crooks,18000000,17266359,29934477,11934477,1.6630265,2000,small time crooks2000
4148,pollock,6000000,8596914,10557291,4557291,1.7595485,2000,pollock2000
4154,the virgin suicides,6000000,4859475,10619770,4619770,1.7699616666666667,2000,the virgin suicides2000
5410,mercy streets,600000,173599,173599,-426401,0.28933166666666665,2000,mercy streets2000
1094,erin brockovich,50000000,125548685,257805243,207805243,5.15610486,2000,erin brockovich2000
3213,gossip,14000000,5108820,12591270,-1408730,0.8993764285714285,2000,gossip2000
1336,28 days,43000000,37035515,62063972,19063972,1.4433481860465116,2000,28 days2000
2376,pitch black,23000000,39235088,53182088,30182088,2.312264695652174,2000,pitch black2000
1215,traffic,48000000,124107476,208300000,160300000,4.339583333333334,2000,traffic2000
355,gladiator,103000000,187683805,457683805,354683805,4.443532087378641,2000,gladiator2000
1766,i dreamed of africa,34000000,6543194,14291999,-19708001,0.4203529117647059,2000,i dreamed of africa2000
3800,beautiful,9000000,3134509,3134509,-5865491,0.34827877777777777,2000,beautiful2000
4009,michael jordan to the max,7000000,18642318,18642318,11642318,2.663188285714286,2000,michael jordan to the max2000
283,mission impossible 2,120000000,215409889,549588516,429588516,4.5799043,2000,mission impossible 22000
3794,the way of the gun,9000000,6047856,13061935,4061935,1.451326111111111,2000,the way of the gun2000
468,mission to mars,90000000,60874615,106000000,16000000,1.1777777777777778,2000,mission to mars2000
5256,panic,1000000,779137,1425707,425707,1.425707,2000,panic2000
1904,pokemon 2000,30000000,43746923,133946923,103946923,4.464897433333333,2000,pokemon 20002000
1076,me myself  irene,51000000,90570999,149270999,98270999,2.9268823333333334,2000,me myself  irene2000
282,how the grinch stole christmas,123000000,260044825,345141403,222141403,2.8060276666666666,2000,how the grinch stole christmas2000
963,the flintstones in viva rock vegas,58000000,35231365,59431365,1431365,1.0246787068965517,2000,the flintstones in viva rock vegas2000
1477,bless the child,40000000,29374178,40435694,435694,1.01089235,2000,bless the child2000
3783,boiler room,9000000,16963963,28773637,19773637,3.197070777777778,2000,boiler room2000
2618,loser,20000000,15464026,18250106,-1749894,0.9125053,2000,loser2000
3782,the contender,9000000,17804273,17804273,8804273,1.9782525555555555,2000,the contender2000
3780,down to you,9000000,20035310,20035310,11035310,2.2261455555555556,2000,down to you2000
1830,frequency,31000000,44983704,68079671,37079671,2.1961184193548386,2000,frequency2000
1311,all the pretty horses,45000000,15527125,18120267,-26879733,0.4026726,2000,all the pretty horses2000
1055,shaft,53012938,70327868,107190108,54177170,2.0219612804708165,2000,shaft2000
4952,hum to mohabbt karega,2000000,121807,121807,-1878193,0.0609035,2000,hum to mohabbt karega2000
5167,but im a cheerleader,1200000,2205627,2509344,1309344,2.09112,2000,but im a cheerleader2000
420,the road to el dorado,95000000,50802661,65700000,-29300000,0.6915789473684211,2000,the road to el dorado2000
1256,miss congeniality,45000000,106807667,213420951,168420951,4.7426878,2000,miss congeniality2000
2742,thomas and the magic railroad,19000000,15911332,15911332,-3088668,0.8374385263157895,2000,thomas and the magic railroad2000
5440,groove,500000,1115313,1167524,667524,2.335048,2000,groove2000
3898,shadow of the vampire,8000000,8279017,8279017,279017,1.034877125,2000,shadow of the vampire2000
985,meet the parents,55000000,166225040,330425040,275425040,6.007728,2000,meet the parents2000
3994,my dog skip,7000000,34099640,35795319,28795319,5.113617,2000,my dog skip2000
1475,the art of war,40000000,30199105,30199105,-9800895,0.754977625,2000,the art of war2000
2337,the whole nine yards,24000000,57262492,85527867,61527867,3.563661125,2000,the whole nine yards2000
4241,a room for romeo brass,5250000,20097,20097,-5229903,0.003828,2000,a room for romeo brass2000
3118,the in crowd,15000000,5217498,5217498,-9782502,0.3478332,2000,the in crowd2000
2725,scary movie,19000000,157019771,277200000,258200000,14.589473684210526,2000,scary movie2000
2807,center stage,18000000,17200925,21361109,3361109,1.1867282777777777,2000,center stage2000
1013,shanghai noon,55000000,56932305,71189835,16189835,1.2943606363636364,2000,shanghai noon2000
3752,next friday,9500000,57176582,59675307,50175307,6.281611263157894,2000,next friday2000
257,dinosaur,127500000,137748063,356148063,228648063,2.7933181411764707,2000,dinosaur2000
4281,billy elliot,5000000,21995263,109253745,104253745,21.850749,2000,billy elliot2000
3691,cecil b demented,10000000,1276984,1953882,-8046118,0.1953882,2000,cecil b demented2000
2692,the yards,20000000,882710,2282710,-17717290,0.1141355,2000,the yards2000
4921,ghost dog the way of the samurai,2000000,3330230,10672492,8672492,5.336246,2000,ghost dog the way of the samurai2000
444,what lies beneath,90000000,155464351,288693989,198693989,3.207710988888889,2000,what lies beneath2000
5223,godzilla 2000,1000000,10037390,10037390,9037390,10.03739,2000,godzilla 20002000
1276,coyote ugly,45000000,60786269,113916474,68916474,2.5314772,2000,coyote ugly2000
1462,hanging up,40000000,36037909,51867723,11867723,1.296693075,2000,hanging up2000
5246,the broken hearts club a romantic comedy,1000000,1744858,2022442,1022442,2.022442,2000,the broken hearts club a romantic comedy2000
447,charlies angels,90000000,125305545,259736090,169736090,2.8859565555555555,2000,charlies angels2000
1465,pay it forward,40000000,33508922,55696705,15696705,1.392417625,2000,pay it forward2000
1456,autumn in new york,40000000,37752931,90717684,50717684,2.2679421,2000,autumn in new york2000
2345,return to me,24000000,32662299,32662299,8662299,1.360929125,2000,return to me2000
1573,the ninth gate,38000000,18653746,58394308,20394308,1.5366923157894736,2000,the ninth gate2000
1335,finding forrester,43000000,51768623,80013623,37013623,1.8607819302325581,2000,finding forrester2000
926,the legend of bagger vance,60000000,30695227,39235486,-20764514,0.6539247666666667,2000,the legend of bagger vance2000
3491,the ladies man,11000000,13592872,13719474,2719474,1.247224909090909,2000,the ladies man2000
921,almost famous,60000000,32522352,47371191,-12628809,0.78951985,2000,almost famous2000
648,vertical limit,75000000,68473360,213500000,138500000,2.8466666666666667,2000,vertical limit2000
665,titan ae,75000000,22751979,36751979,-38248021,0.49002638666666665,2000,titan ae2000
487,cast away,85000000,233632142,427230516,342230516,5.026241364705882,2000,cast away2000
1720,dungeons and dragons,35000000,15185241,33771965,-1228035,0.9649132857142857,2000,dungeons and dragons2000
5747,the terrorist,25000,195043,195043,170043,7.80172,2000,the terrorist2000
4841,anatomie,2500000,9598,9598,-2490402,0.0038392,2000,anatomie2000
624,the adventures of rocky  bullwinkle,76000000,26000610,35129610,-40870390,0.4622317105263158,2000,the adventures of rocky  bullwinkle2000
526,nutty professor ii the klumps,84000000,123307945,166307945,82307945,1.979856488095238,2000,nutty professor ii the klumps2000
817,lucky numbers,65000000,10014234,10014234,-54985766,0.15406513846153846,2000,lucky numbers2000
808,proof of life,65000000,32598931,62761005,-2238995,0.9655539230769231,2000,proof of life2000
604,red planet,80000000,17480890,33463969,-46536031,0.4182996125,2000,red planet2000
2570,high fidelity,20000000,27277055,47881663,27881663,2.39408315,2000,high fidelity2000
3581,snatch,10000000,30093107,83593107,73593107,8.3593107,2000,snatch2000
2947,boys and girls,16000000,21799652,21799652,5799652,1.36247825,2000,boys and girls2000
597,battlefield earth a saga of the year 3000,80000000,21471685,29725663,-50274337,0.3715707875,2000,battlefield earth a saga of the year 30002000
4750,just looking,3000000,39852,39852,-2960148,0.013284,2000,just looking2000
3097,here on earth,15000000,10494147,10845127,-4154873,0.7230084666666666,2000,here on earth2000
4322,digimon the movie,5000000,9628751,16628751,11628751,3.3257502,2000,digimon the movie2000
505,102 dalmatians,85000000,66941559,66941559,-18058441,0.7875477529411765,2000,102 dalmatians2000
4645,human traffic,3300000,104257,5422740,2122740,1.6432545454545455,2000,human traffic2000
3088,highlander endgame,15000000,12801190,12801190,-2198810,0.8534126666666667,2000,highlander endgame2000
2437,the little vampire,22000000,13555988,13555988,-8444012,0.6161812727272727,2000,the little vampire2000
5541,gods army,300000,2637726,2652515,2352515,8.841716666666667,2000,gods army2000
4827,jesus son,2500000,1282084,1687548,-812452,0.6750192,2000,jesus son2000
3077,eye of the beholder,15000000,16500786,18260865,3260865,1.217391,2000,eye of the beholder2000
3065,urban legends final cut,15000000,21468807,38574362,23574362,2.571624133333333,2000,urban legends final cut2000
2188,romeo must die,25000000,55973336,91036760,66036760,3.6414704,2000,romeo must die2000
674,unbreakable,73243106,94999143,248099143,174856037,3.387337819889834,2000,unbreakable2000
3410,screwed,12000000,6982680,6982680,-5017320,0.58189,2000,screwed2000
593,thirteen days,80000000,34566746,66554547,-13445453,0.8319318375,2000,thirteen days2000
4433,requiem for a dream,4500000,3635482,7389233,2889233,1.6420517777777779,2000,requiem for a dream2000
1712,wonder boys,35000000,19389454,33422485,-1577515,0.9549281428571429,2000,wonder boys2000
3674,the house of mirth,10000000,3041803,5149131,-4850869,0.5149131,2000,the house of mirth2000
3106,whatever it takes,15000000,8735529,8735529,-6264471,0.5823686,2000,whatever it takes2000
635,xmen,75000000,157299717,296872367,221872367,3.958298226666667,2000,xmen2000
2966,duets,16000000,4734235,6615452,-9384548,0.41346575,2000,duets2000
940,supernova,60000000,14218868,14816494,-45183506,0.24694156666666667,2000,supernova2000
2182,chocolat,25000000,71309760,152500343,127500343,6.10001372,2000,chocolat2000
3660,black and white,10000000,5241315,5241315,-4758685,0.5241315,2000,black and white2000
1502,get carter,40000000,14967182,19417182,-20582818,0.48542955,2000,get carter2000
1719,bait,35000000,15325127,15471969,-19528031,0.4420562571428571,2000,bait2000
793,the kid,65000000,69688384,69688384,4688384,1.0721289846153845,2000,the kid2000
3678,bamboozled,10000000,2185266,2373937,-7626063,0.2373937,2000,bamboozled2000
1676,bounce,35000000,36805288,53425292,18425292,1.5264369142857144,2000,bounce2000
534,the 6th day,82000000,34543701,96024898,14024898,1.1710353414634147,2000,the 6th day2000
5727,george washington,42000,241816,342722,300722,8.160047619047619,2000,george washington2000
4710,east is east,3000000,4170647,30438635,27438635,10.146211666666666,2000,east is east2000
1618,isnt she great,36000000,2954405,2954405,-33045595,0.08206680555555555,2000,isnt she great2000
3041,where the heart is,15000000,33771174,40862054,25862054,2.7241369333333334,2000,where the heart is2000
2953,drowning mona,16000000,15427192,15980376,-19624,0.9987735,2000,drowning mona2000
2929,road trip,16000000,68525609,119739110,103739110,7.483694375,2000,road trip2000
5575,chuckbuck,250000,1055671,1157672,907672,4.630688,2000,chuckbuck2000
3036,the skulls,15000000,35007180,35007180,20007180,2.333812,2000,the skulls2000
2019,keeping the faith,29000000,37036404,45336404,16336404,1.563324275862069,2000,keeping the faith2000
4711,whipped,3000000,4142507,4142507,1142507,1.3808356666666666,2000,whipped2000
4494,saving grace,4000000,12178602,27786849,23786849,6.94671225,2000,saving grace2000
1649,the cell,35000000,61280963,85911226,50911226,2.454606457142857,2000,the cell2000
2998,crouching tiger hidden dragon,15000000,128067808,213514672,198514672,14.234311466666666,2000,crouching tiger hidden dragon2000
5364,deterrence,800000,144583,371647,-428353,0.46455875,2000,deterrence2000
461,hollow man,90000000,73209340,191200000,101200000,2.1244444444444444,2000,hollow man2000
1797,men of honor,32000000,48814909,82339483,50339483,2.57310884375,2000,men of honor2000
3685,gun shy,10000000,1638202,1638202,-8361798,0.1638202,2000,gun shy2000
2266,the next best thing,25000000,14983572,24355762,-644238,0.97423048,2000,the next best thing2000
4500,3 strikes,4000000,9821335,9821335,5821335,2.45533375,2000,3 strikes2000
830,u571,62000000,77086030,127630030,65630030,2.058548870967742,2000,u5712000
5729,smiling fish and goat on fire,40000,277233,277233,237233,6.930825,2000,smiling fish and goat on fire2000
3236,quills,13500000,7060876,11732088,-1767912,0.8690435555555556,2000,quills2000
4543,an everlasting piece,4000000,75078,75078,-3924922,0.0187695,2000,an everlasting piece2000
5619,trois,200000,1161843,1161843,961843,5.809215,2000,trois2000
3543,bring it on,10000000,68353550,90453550,80453550,9.045355,2000,bring it on2000
2532,the tigger movie,20000000,45542421,96147688,76147688,4.8073844,2000,the tigger movie2000
586,little nicky,80000000,39442871,58270391,-21729609,0.7283798875,2000,little nicky2000
787,space cowboys,65000000,90454043,128874043,63874043,1.9826775846153846,2000,space cowboys2000
4533,psycho beach party,4000000,267972,267972,-3732028,0.066993,2000,psycho beach party2000
869,the family man,60000000,75764085,124715863,64715863,2.0785977166666667,2000,the family man2000
4535,the big tease,4000000,185577,185577,-3814423,0.04639425,2000,the big tease2000
2060,dracula 2000,28000000,33000377,33000377,5000377,1.178584892857143,2000,dracula 20002000
5658,the woman chaser,150000,110719,110719,-39281,0.7381266666666667,2000,the woman chaser2000
771,what women want,65000000,182805123,374105123,309105123,5.755463430769231,2000,what women want2000
2070,lost souls,28000000,16779636,31320293,3320293,1.118581892857143,2000,lost souls2000
4613,la otra conquista,3500000,886410,886410,-2613590,0.25326,2000,la otra conquista2000
5610,urbania,225000,1032075,1032075,807075,4.587,2000,urbania2000
3057,book of shadows blair witch 2,15000000,26421314,47721314,32721314,3.1814209333333334,2000,book of shadows blair witch 22000
3627,the gift,10000000,12008642,44567606,34567606,4.4567606,2000,the gift2000
3055,love and basketball,15000000,27441122,27709625,12709625,1.8473083333333333,2000,love and basketball2000
3630,the legend of drunken master,10000000,11546543,11546543,1546543,1.1546543,2000,the legend of drunken master2000
1614,reindeer games,36000000,23360779,23360779,-12639221,0.6489105277777778,2000,reindeer games2000
2134,o brother where art thou,26000000,45506619,75763814,49763814,2.913992846153846,2000,o brother where art thou2000
880,rules of engagement,60000000,61322858,71719931,11719931,1.1953321833333332,2000,rules of engagement2000
5090,session 9,1500000,378176,1619602,119602,1.0797346666666667,2001,session 92001
5038,in the bedroom,1700000,35930604,42137871,40437871,24.786982941176472,2001,in the bedroom2001
4102,aberdeen,6500000,64148,64148,-6435852,0.009868923076923077,2001,aberdeen2001
342,the lord of the rings the fellowship of the ring,109000000,315544750,887210985,778210985,8.139550321100918,2001,the lord of the rings the fellowship of the ring2001
344,ali,109000000,58183966,87683966,-21316034,0.8044400550458716,2001,ali2001
1226,kate and leopold,48000000,47095453,70937778,22937778,1.477870375,2001,kate and leopold2001
3662,on the line,10000000,4365455,4690802,-5309198,0.4690802,2001,on the line2001
409,the mummy returns,98000000,202007640,435040395,337040395,4.4391877040816325,2001,the mummy returns2001
4171,the business of strangers,6000000,1030920,1290920,-4709080,0.21515333333333334,2001,the business of strangers2001
5244,sidewalks of new york,1000000,2402459,3575308,2575308,3.575308,2001,sidewalks of new york2001
1061,domestic disturbance,53000000,45207112,54207112,1207112,1.0227756981132075,2001,domestic disturbance2001
429,jurassic park iii,93000000,181166115,365900000,272900000,3.934408602150538,2001,jurassic park iii2001
4942,dinner rush,2000000,638227,1075504,-924496,0.537752,2001,dinner rush2001
3972,the hole,7500000,0,10834406,3334406,1.4445874666666667,2001,the hole2001
427,lara croft tomb raider,94000000,131144183,273330185,179330185,2.907767925531915,2001,lara croft tomb raider2001
262,harry potter and the sorcererâs stone,125000000,317871467,975047606,850047606,7.800380848,2001,harry potter and the sorcererâs stone2001
1082,shrek,50000000,267655011,491812794,441812794,9.83625588,2001,shrek2001
4167,novocaine,6000000,2025238,2522928,-3477072,0.420488,2001,novocaine2001
4958,eureka,2000000,49388,76654,-1923346,0.038327,2001,eureka2001
5023,songcatcher,1800000,3050934,3050934,1250934,1.6949633333333334,2001,songcatcher2001
1306,the pledge,45000000,19719930,29406132,-15593868,0.6534696,2001,the pledge2001
1128,donât say a word,50000000,54997476,104488383,54488383,2.08976766,2001,donât say a word2001
3708,high heels and low lifes,10000000,226792,226792,-9773208,0.0226792,2001,high heels and low lifes2001
1269,scary movie 2,45000000,71277420,141189101,96189101,3.137535577777778,2001,scary movie 22001
5391,lie,700000,1140965,1140965,440965,1.62995,2001,lie2001
938,the last castle,60000000,18208078,20541668,-39458332,0.34236113333333335,2001,the last castle2001
4327,the forsaken,5000000,6755271,6755271,1755271,1.3510542,2001,the forsaken2001
510,enemy at the gates,85000000,51396781,96971293,11971293,1.1408387411764707,2001,enemy at the gates2001
975,captain corellis mandolin,57000000,25528495,62097495,5097495,1.0894297368421053,2001,captain corellis mandolin2001
4878,bully,2100000,881824,1381824,-718176,0.6580114285714286,2001,bully2001
1417,the mexican,40000000,66808615,145238250,105238250,3.63095625,2001,the mexican2001
4296,o othello,5000000,16017403,16017403,11017403,3.2034806,2001,o othello2001
5254,brigham city,1000000,852206,852206,-147794,0.852206,2001,brigham city2001
5251,no mans land,1000000,1067481,2684207,1684207,2.684207,2001,no mans land2001
1060,moulin rouge,53000000,57386369,179200588,126200588,3.381143169811321,2001,moulin rouge2001
1225,kpax,48000000,50315140,50315140,2315140,1.0482320833333334,2001,kpax2001
1223,rat race,48000000,56607223,86607223,38607223,1.8043171458333334,2001,rat race2001
4992,pendulum,2000000,0,0,-2000000,0.0,2001,pendulum2001
4122,the brothers,6000000,27457409,27958191,21958191,4.6596985,2001,the brothers2001
4033,the other side of heaven,7000000,4720371,4720371,-2279629,0.6743387142857142,2001,the other side of heaven2001
1209,the one,49000000,43905746,72689126,23689126,1.4834515510204083,2001,the one2001
306,monsters inc,115000000,289423425,559757719,444757719,4.867458426086957,2001,monsters inc2001
1266,training day,45000000,76261036,104505362,59505362,2.3223413777777777,2001,training day2001
1571,angel eyes,38000000,24044532,29544532,-8455468,0.7774876842105263,2001,angel eyes2001
414,black hawk down,95000000,108638745,159691085,64691085,1.6809587894736842,2001,black hawk down2001
1566,heartbreakers,38000000,40334024,57753825,19753825,1.5198375,2001,heartbreakers2001
687,the majestic,72000000,27796042,37306334,-34693666,0.5181435277777777,2001,the majestic2001
4499,the wash,4000000,10097096,10097096,6097096,2.524274,2001,the wash2001
3602,valentine,10000000,20384136,20384136,10384136,2.0384136,2001,valentine2001
5716,gabriela,50000,2335352,2335352,2285352,46.70704,2001,gabriela2001
3530,le fabuleux destin damãlie poulain,10350000,33201661,174201661,163851661,16.83107835748792,2001,le fabuleux destin damãlie poulain2001
686,driven,72000000,32616869,54616869,-17383131,0.758567625,2001,driven2001
744,osmosis jones,70000000,13596911,13596911,-56403089,0.1942415857142857,2001,osmosis jones2001
5516,jackpot,400000,44452,44452,-355548,0.11113,2001,jackpot2001
1634,spy kids,35000000,112692062,197692062,162692062,5.6483446285714285,2001,spy kids2001
4438,donnie darko,4500000,1480006,7510877,3010877,1.6690837777777778,2001,donnie darko2001
755,the score,68000000,71069884,113542091,45542091,1.6697366323529412,2001,the score2001
5470,everything put together,500000,0,7890,-492110,0.01578,2001,everything put together2001
3646,bones,10000000,7316658,8378853,-1621147,0.8378853,2001,bones2001
4683,pokemon 3 the movie,3000000,17052128,68452128,65452128,22.817376,2001,pokemon 3 the movie2001
4697,the deep end,3000000,8823109,9981635,6981635,3.3272116666666665,2001,the deep end2001
5765,dayereh,10000,673780,673780,663780,67.378,2001,dayereh2001
5767,cure,10000,94596,94596,84596,9.4596,2001,cure2001
152,pearl harbor,151500000,198539855,449239855,297739855,2.9652795709570956,2001,pearl harbor2001
834,3000 miles to graceland,62000000,15738632,18708848,-43291152,0.30175561290322583,2001,3000 miles to graceland2001
4005,kingdom come,7000000,23247539,23393939,16393939,3.3419912857142857,2001,kingdom come2001
1553,the fast and the furious,38000000,144512310,206512310,168512310,5.43453447368421,2001,the fast and the furious2001
683,dr dolittle 2,72000000,112950721,176101721,104101721,2.4458572361111113,2001,dr dolittle 22001
4164,hedwig and the angry inch,6000000,3067312,3740030,-2259970,0.6233383333333333,2001,hedwig and the angry inch2001
1236,riding in cars with boys,47000000,29781453,29781453,-17218547,0.6336479361702128,2001,riding in cars with boys2001
611,a beautiful mind,78000000,170708996,317668058,239668058,4.07266741025641,2001,a beautiful mind2001
352,town  country,105000000,6712451,10364769,-94635231,0.09871208571428572,2001,town  country2001
4611,pootie tang,3500000,3293258,3293258,-206742,0.9409308571428572,2001,pootie tang2001
4465,sexy beast,4300000,6946056,10158355,5858355,2.362408139534884,2001,sexy beast2001
1525,just visiting,40000000,4777007,16172200,-23827800,0.404305,2001,just visiting2001
3629,get over it,10000000,11560259,19860259,9860259,1.9860259,2001,get over it2001
5690,keeping it real the adventures of greg walloch,100000,1358,1358,-98642,0.01358,2001,keeping it real the adventures of greg walloch2001
858,cats  dogs,60000000,93375151,200700000,140700000,3.345,2001,cats  dogs2001
3561,jeepers creepers,10000000,37904175,58939035,48939035,5.8939035,2001,jeepers creepers2001
3564,recess schools out,10000000,36696761,44451470,34451470,4.445147,2001,recess schools out2001
706,vanilla sky,70000000,100614858,202726605,132726605,2.8960943571428572,2001,vanilla sky2001
658,bandits,75000000,41523271,71523271,-3476729,0.9536436133333334,2001,bandits2001
1582,texas rangers,38000000,623374,623374,-37376626,0.01640457894736842,2001,texas rangers2001
1577,rock star,38000000,16991902,19317765,-18682235,0.5083622368421052,2001,rock star2001
5576,american desi,250000,902835,1366235,1116235,5.46494,2001,american desi2001
669,monkeybone,75000000,5409517,5409517,-69590483,0.07212689333333333,2001,monkeybone2001
1572,joe somebody,38000000,22770864,24515990,-13484010,0.6451576315789473,2001,joe somebody2001
4483,monsters ball,4000000,31273922,43766463,39766463,10.94161575,2001,monsters ball2001
575,swordfish,80000000,69772969,147080413,67080413,1.8385051625,2001,swordfish2001
4334,made,5000000,5308707,5476060,476060,1.095212,2001,made2001
1482,the musketeer,40000000,27053815,27053815,-12946185,0.676345375,2001,the musketeer2001
1930,whats the worst that could happen,30000000,32267774,38462071,8462071,1.2820690333333333,2001,whats the worst that could happen2001
2435,josie and the pussycats,22000000,14252830,14252830,-7747170,0.6478559090909091,2001,josie and the pussycats2001
2417,i am sam,22000000,40270895,92542418,70542418,4.206473545454545,2001,i am sam2001
2215,kiss of the dragon,25000000,36833473,36833473,11833473,1.47333892,2001,kiss of the dragon2001
2866,the others,17000000,96522687,207765056,190765056,12.22147388235294,2001,the others2001
1724,american outlaws,35000000,13264986,13601109,-21398891,0.3886031142857143,2001,american outlaws2001
2422,jay and silent bob strike back,22000000,30059386,33762400,11762400,1.5346545454545455,2001,jay and silent bob strike back2001
1726,the shipping news,35000000,11405825,24405825,-10594175,0.6973092857142857,2001,the shipping news2001
3162,pandaemonium,15000000,0,0,-15000000,0.0,2001,pandaemonium2001
3392,max keebles big move,12000000,17292381,17292381,5292381,1.44103175,2001,max keebles big move2001
2181,bridget joness diary,25000000,71500556,281527158,256527158,11.26108632,2001,bridget joness diary2001
3372,how high,12000000,31155435,31222395,19222395,2.60186625,2001,how high2001
1976,antitrust,30000000,10965209,17865209,-12134791,0.5955069666666667,2001,antitrust2001
2892,summer catch,17000000,19693891,19693891,2693891,1.1584641764705883,2001,summer catch2001
3113,mulholland drive,15000000,7219578,20785973,5785973,1.3857315333333333,2001,mulholland drive2001
2432,the glass house,22000000,17951431,22861785,861785,1.0391720454545454,2001,the glass house2001
3208,head over heels,14000000,10397365,10397365,-3602635,0.7426689285714285,2001,head over heels2001
2811,life as a house,18000000,15652637,23889158,5889158,1.3271754444444444,2001,life as a house2001
1703,heist,35000000,23483357,28906817,-6093183,0.8259090571428571,2001,heist2001
2411,the animal,22000000,55762229,55762229,33762229,2.534646772727273,2001,the animal2001
3218,soul survivors,14000000,3100650,4288246,-9711754,0.3063032857142857,2001,soul survivors2001
3082,freddy got fingered,15000000,14249005,14249005,-750995,0.9499336666666667,2001,freddy got fingered2001
2816,the tailor of panama,18000000,13491653,27491653,9491653,1.5273140555555555,2001,the tailor of panama2001
588,evolution,80000000,38311134,98341932,18341932,1.22927415,2001,evolution2001
2942,baby boy,16000000,28734552,28734552,12734552,1.7959095,2001,baby boy2001
3492,tomcats,11000000,13558739,13558739,2558739,1.2326126363636363,2001,tomcats2001
2348,double take,24000000,29823162,29823162,5823162,1.24263175,2001,double take2001
3277,crazybeautiful,13000000,16929123,19929123,6929123,1.5330094615384615,2001,crazybeautiful2001
3291,bubble boy,13000000,5002310,5002310,-7997690,0.3847930769230769,2001,bubble boy2001
3490,out cold,11000000,13906394,14786394,3786394,1.3442176363636364,2001,out cold2001
3273,two can play that game,13000000,22235901,22391450,9391450,1.7224192307692308,2001,two can play that game2001
3297,the widow of st pierre,13000000,3058380,3058380,-9941620,0.23526,2001,the widow of st pierre2001
2733,thirteen ghosts,19000000,41867960,68467960,49467960,3.603576842105263,2001,thirteen ghosts2001
2075,john carpenterâs ghosts of mars,28000000,8434601,8434601,-19565399,0.30123575,2001,john carpenterâs ghosts of mars2001
1840,american pie 2,30000000,145096820,286500000,256500000,9.55,2001,american pie 22001
3484,corky romano,11000000,23978402,25116103,14116103,2.2832820909090907,2001,corky romano2001
1831,hearts in atlantis,31000000,24185781,30885781,-114219,0.9963155161290322,2001,hearts in atlantis2001
2143,original sin,26000000,16521410,16521410,-9478590,0.6354388461538462,2001,original sin2001
2943,joe dirt,16000000,27087695,30987695,14987695,1.9367309375,2001,joe dirt2001
2430,saving silverman,22000000,19351569,25873142,3873142,1.1760519090909092,2001,saving silverman2001
1683,black knight,35000000,33422806,33422806,-1577194,0.9549373142857143,2001,black knight2001
2465,hardball,21000000,40222729,43728560,22728560,2.082312380952381,2001,hardball2001
2174,jimmy neutron boy genius,25000000,80936232,102992536,77992536,4.11970144,2001,jimmy neutron boy genius2001
2762,left behind,18500000,4221341,4221341,-14278659,0.22818059459459458,2001,left behind2001
2239,crocodile dundee in los angeles,25000000,25590119,39393111,14393111,1.57572444,2001,crocodile dundee in los angeles2001
2767,legally blonde,18000000,96493426,141809235,123809235,7.878290833333334,2001,legally blonde2001
5286,speedway junky,1000000,17127,17127,-982873,0.017127,2001,speedway junky2001
485,hannibal,87000000,165092266,350100280,263100280,4.0241411494252874,2001,hannibal2001
5277,lisa picard is famous,1000000,113433,113433,-886567,0.113433,2001,lisa picard is famous2001
466,spy game,90000000,62362560,143049560,53049560,1.5894395555555556,2001,spy game2001
1371,a knightâs tale,41000000,56083966,100622586,59622586,2.454209414634146,2001,a knightâs tale2001
459,artificial intelligence ai,90000000,78616689,235900000,145900000,2.621111111111111,2001,artificial intelligence ai2001
3845,glitter,8500000,4273372,4273372,-4226628,0.5027496470588235,2001,glitter2001
1359,15 minutes,42000000,24375436,56331864,14331864,1.3412348571428572,2001,15 minutes2001
223,final fantasy the spirits within,137000000,32131830,85131830,-51868170,0.6214002189781022,2001,final fantasy the spirits within2001
440,rush hour 2,90000000,226164286,347425832,257425832,3.8602870222222223,2001,rush hour 22001
4222,iris,5500000,5580479,5580479,80479,1.0146325454545455,2001,iris2001
4221,ghost world,5500000,6217849,8761608,3261608,1.5930196363636364,2001,ghost world2001
3935,akira,8000000,19585,19585,-7980415,0.002448125,2001,akira2001
456,atlantis the lost empire,90000000,84052762,186049020,96049020,2.0672113333333333,2001,atlantis the lost empire2001
4276,memento,5000000,25544867,39723096,34723096,7.9446192,2001,memento2001
489,oceans eleven,85000000,183417150,450728529,365728529,5.302688576470588,2001,oceans eleven2001
1412,shallow hal,40000000,70836296,70836296,30836296,1.7709074,2001,shallow hal2001
2299,say it isnt so,25000000,5516708,5516708,-19483292,0.22066832,2001,say it isnt so2001
1486,sweet november,40000000,25288103,65754228,25754228,1.6438557,2001,sweet november2001
1423,behind enemy lines,40000000,58855732,58855732,18855732,1.4713933,2001,behind enemy lines2001
1244,americas sweethearts,46000000,93607673,160648493,114648493,3.492358543478261,2001,americas sweethearts2001
4913,amores perros,2000000,5383834,20883834,18883834,10.441917,2001,amores perros2001
2148,the curse of the jade scorpion,26000000,7496522,18496522,-7503478,0.7114046923076923,2001,the curse of the jade scorpion2001
1872,down to earth,30000000,64172251,71172251,41172251,2.372408366666667,2001,down to earth2001
3239,the cavemans valentine,13500000,687081,892506,-12607494,0.06611155555555556,2001,the cavemans valentine2001
3246,save the last dance,13000000,91038276,122244329,109244329,9.403409923076923,2001,save the last dance2001
2054,zoolander,28000000,45172250,60780981,32780981,2.1707493214285716,2001,zoolander2001
2940,see spot run,16000000,33357476,43057552,27057552,2.691097,2001,see spot run2001
2787,gosford park,18000000,41300105,41300105,23300105,2.294450277777778,2001,gosford park2001
3443,company man,12000000,146028,622273,-11377727,0.05185608333333333,2001,company man2001
1850,the princess diaries,30000000,108244774,165334774,135334774,5.511159133333333,2001,the princess diaries2001
2050,the royal tenenbaums,28000000,52353636,71430876,43430876,2.5511027142857143,2001,the royal tenenbaums2001
2046,the wedding planner,28000000,60400856,94728529,66728529,3.38316175,2001,the wedding planner2001
2052,serendipity,28000000,50255310,77477297,49477297,2.7670463214285714,2001,serendipity2001
3031,not another teen movie,15000000,37882551,62401343,47401343,4.160089533333333,2001,not another teen movie2001
1687,from hell,35000000,31598308,68712365,33712365,1.9632104285714285,2001,from hell2001
1771,exit wounds,33000000,51758599,79958599,46958599,2.4229878484848486,2001,exit wounds2001
3435,brother,12000000,450594,450594,-11549406,0.0375495,2001,brother2001
2380,joy ride,23000000,21973182,21973182,-1026818,0.9553557391304348,2001,joy ride2001
1889,blow,30000000,52990775,83282296,53282296,2.7760765333333333,2001,blow2001
2378,someone like you,23000000,27338033,38684906,15684906,1.6819524347826087,2001,someone like you2001
2038,along came a spider,28000000,74058698,105159085,77159085,3.755681607142857,2001,along came a spider2001
2444,megiddo omega code 2,22000000,6047691,6047691,-15952309,0.27489504545454546,2001,megiddo omega code 22001
2609,the country bears,20000000,16988996,16988996,-3011004,0.8494498,2002,the country bears2002
5416,crop circles quest for truth,600000,0,0,-600000,0.0,2002,crop circles quest for truth2002
1512,feardotcom,40000000,13208023,13208023,-26791977,0.330200575,2002,feardotcom2002
3655,deuces wild,10000000,6044618,6244618,-3755382,0.6244618,2002,deuces wild2002
3700,swept away,10000000,598645,598645,-9401355,0.0598645,2002,swept away2002
3686,nicholas nickleby,10000000,1562800,1562800,-8437200,0.15628,2002,nicholas nickleby2002
3377,frida,12000000,25885000,56131239,44131239,4.67760325,2002,frida2002
5446,never again,500000,307631,308793,-191207,0.617586,2002,never again2002
5328,charly,950000,814666,814666,-135334,0.8575431578947369,2002,charly2002
1740,femme fatale,35000000,6630252,16830252,-18169748,0.48086434285714286,2002,femme fatale2002
5379,interview with the assassin,750000,47329,47329,-702671,0.06310533333333333,2002,interview with the assassin2002
3405,sorority boys,12000000,10198766,12516222,516222,1.0430185,2002,sorority boys2002
2635,undisputed,20000000,12398628,12398628,-7601372,0.6199314,2002,undisputed2002
3369,one hour photo,12000000,31597131,52223306,40223306,4.3519421666666664,2002,one hour photo2002
3366,crossroads,12000000,37188667,57000000,45000000,4.75,2002,crossroads2002
5510,dogtown and zboys,400000,1293295,1600566,1200566,4.001415,2002,dogtown and zboys2002
5362,pandoras box,800000,881950,881950,81950,1.1024375,2002,pandoras box2002
1715,the four feathers,35000000,18306166,29882645,-5117355,0.8537898571428572,2002,the four feathers2002
1522,impostor,40000000,6114237,7974607,-32025393,0.199365175,2002,impostor2002
1524,extreme ops,40000000,4835968,12624471,-27375529,0.315611775,2002,extreme ops2002
1504,life or something like it,40000000,14448589,14448589,-25551411,0.361214725,2002,life or something like it2002
5354,time changer,825000,1500711,1500711,675711,1.8190436363636364,2002,time changer2002
1431,the count of monte cristo,40000000,54228104,75389090,35389090,1.88472725,2002,the count of monte cristo2002
1491,city by the sea,40000000,22433915,22433915,-17566085,0.560847875,2002,city by the sea2002
3875,brown sugar,8000000,27362712,28315272,20315272,3.539409,2002,brown sugar2002
3797,igby goes down,9000000,4777465,4777465,-4222535,0.5308294444444445,2002,igby goes down2002
5532,revolution9,350000,9118,9118,-340882,0.026051428571428573,2002,revolution92002
3624,hey arnold the movie,10000000,13684949,13684949,3684949,1.3684949,2002,hey arnold the movie2002
5275,love liza,1000000,213137,213137,-786863,0.213137,2002,love liza2002
218,spiderman,139000000,403706375,821706375,682706375,5.911556654676259,2002,spiderman2002
5553,ayurveda art of being,300000,16892,2066892,1766892,6.88964,2002,ayurveda art of being2002
5570,lovely and amazing,250000,4210379,4613482,4363482,18.453928,2002,lovely and amazing2002
3615,kung pow enter the fist,10000000,16033556,17033556,7033556,1.7033556,2002,kung pow enter the fist2002
1369,8 mile,41000000,116724075,245768384,204768384,5.994350829268293,2002,8 mile2002
5298,the jimmy show,1000000,703,703,-999297,0.000703,2002,the jimmy show2002
1355,the mothman prophecies,42000000,35228696,56438555,14438555,1.343775119047619,2002,the mothman prophecies2002
3893,the good girl,8000000,14018296,16585503,8585503,2.073187875,2002,the good girl2002
3423,last orders,12000000,2326407,2326407,-9673593,0.19386725,2002,last orders2002
5625,hybrid,200000,162605,162605,-37395,0.813025,2002,hybrid2002
1554,sweet home alabama,38000000,127214072,182365114,144365114,4.799081947368421,2002,sweet home alabama2002
1338,the sweetest thing,43000000,24430272,63078756,20078756,1.4669478139534884,2002,the sweetest thing2002
1791,snow dogs,32000000,81150692,116898028,84898028,3.653063375,2002,snow dogs2002
3427,the dangerous lives of altar boys,12000000,1779284,1779284,-10220716,0.14827366666666666,2002,the dangerous lives of altar boys2002
1691,queen of the damned,35000000,30307804,30307804,-4692196,0.8659372571428572,2002,queen of the damned2002
2527,peter pan return to neverland,20000000,48430258,109862682,89862682,5.4931341,2002,peter pan return to neverland2002
3320,the emperors club,12500000,14060950,16193713,3693713,1.29549704,2002,the emperors club2002
5624,the business of fancy dancing,200000,174682,174682,-25318,0.87341,2002,the business of fancy dancing2002
5654,the calling,160000,32092,32092,-127908,0.200575,2002,the calling2002
3813,all or nothing,9000000,184255,184255,-8815745,0.020472777777777777,2002,all or nothing2002
5437,the singles ward,500000,1250798,1250798,750798,2.501596,2002,the singles ward2002
2631,the quiet american,20000000,12987647,26348203,6348203,1.31741015,2002,the quiet american2002
3580,the banger sisters,10000000,30306281,38067218,28067218,3.8067218,2002,the banger sisters2002
3908,8 femmes,8000000,3076425,42376425,34376425,5.297053125,2002,8 femmes2002
4039,auto focus,7000000,2062066,2703821,-4296179,0.38626014285714283,2002,auto focus2002
1273,changing lanes,45000000,66790248,66790248,21790248,1.4842277333333334,2002,changing lanes2002
1238,solaris,47000000,14970038,14970038,-32029962,0.3185114468085106,2002,solaris2002
5159,monsoon wedding,1200000,13876974,27025600,25825600,22.521333333333335,2002,monsoon wedding2002
3318,antwone fisher,12500000,21078145,23367586,10867586,1.86940688,2002,antwone fisher2002
1685,the pianist,35000000,32519322,111854182,76854182,3.1958337714285716,2002,the pianist2002
3588,swimfan,10000000,28564995,34084228,24084228,3.4084228,2002,swimfan2002
3316,the crocodile hunter collision course,12500000,28436931,33436931,20936931,2.67495448,2002,the crocodile hunter collision course2002
3960,narc,7500000,10465659,11843260,4343260,1.5791013333333332,2002,narc2002
1567,enough,38000000,39177215,50970660,12970660,1.341333157894737,2002,enough2002
739,harts war,70000000,19076815,33076815,-36923185,0.47252592857142856,2002,harts war2002
3963,men with brooms,7500000,4239767,4239767,-3260233,0.5653022666666667,2002,men with brooms2002
5657,tadpole,150000,2891288,3270128,3120128,21.800853333333333,2002,tadpole2002
2688,equilibrium,20000000,1190018,5345869,-14654131,0.26729345,2002,equilibrium2002
3970,betty fisher et autres histoires,7500000,206400,206400,-7293600,0.02752,2002,betty fisher et autres histoires2002
2408,the rookie,22000000,75600072,80491516,58491516,3.6587052727272726,2002,the rookie2002
5198,sex with strangers,1100000,247740,247740,-852260,0.22521818181818182,2002,sex with strangers2002
2469,the transporter,21000000,25296447,43928932,22928932,2.091853904761905,2002,the transporter2002
3571,friday after next,10000000,33253609,33526835,23526835,3.3526835,2002,friday after next2002
1669,resident evil,35000000,40119709,103787401,68787401,2.9653543142857144,2002,resident evil2002
2518,drumline,20000000,56398162,56398162,36398162,2.8199081,2002,drumline2002
208,men in black 2,140000000,190418803,441767803,301767803,3.1554843071428573,2002,men in black 22002
3292,birthday girl,13000000,4919896,8130727,-4869273,0.6254405384615385,2002,birthday girl2002
3500,slackers,11000000,4814244,5942218,-5057782,0.5402016363636364,2002,slackers2002
5072,kissing jessica stein,1500000,7025722,9345061,7845061,6.230040666666667,2002,kissing jessica stein2002
2280,the powerpuff girls,25000000,11411644,16425701,-8574299,0.65702804,2002,the powerpuff girls2002
1320,big trouble,45000000,7262288,8488871,-36511129,0.1886415777777778,2002,big trouble2002
1606,john q,36000000,71026631,102226631,66226631,2.8396286388888887,2002,john q2002
2744,sen to chihiro no kamikakushi,19000000,10049886,274949886,255949886,14.471046631578947,2002,sen to chihiro no kamikakushi2002
1246,insomnia,46000000,67263182,113622499,67622499,2.4700543260869567,2002,insomnia2002
294,stuart little 2,120000000,64956806,166000000,46000000,1.3833333333333333,2002,stuart little 22002
3475,a walk to remember,11000000,41227069,46060861,35060861,4.187351,2002,a walk to remember2002
3436,welcome to collinwood,12000000,378650,4606284,-7393716,0.383857,2002,welcome to collinwood2002
2758,adaptation,18500000,22498520,32531759,14031759,1.7584734594594595,2002,adaptation2002
1838,chicago,30000000,170687518,306770545,276770545,10.225684833333334,2002,chicago2002
4029,rabbitproof fence,7000000,6199600,16866928,9866928,2.409561142857143,2002,rabbitproof fence2002
1216,panic room,48000000,95308367,196308367,148308367,4.089757645833333,2002,panic room2002
1214,the ring,48000000,129094024,248218486,200218486,5.171218458333334,2002,the ring2002
3263,the new guy,13000000,28972187,28972187,15972187,2.228629769230769,2002,the new guy2002
5158,super troopers,1200000,18492362,23046142,21846142,19.205118333333335,2002,super troopers2002
305,star wars ep ii attack of the clones,115000000,310676740,656695615,541695615,5.710396652173913,2002,star wars ep ii attack of the clones2002
2477,moonlight mile,21000000,6830957,6830957,-14169043,0.3252836666666667,2002,moonlight mile2002
310,windtalkers,115000000,40914068,77628265,-37371735,0.6750283913043478,2002,windtalkers2002
5100,stolen summer,1500000,119841,119841,-1380159,0.079894,2002,stolen summer2002
1196,death to smoochy,50000000,8355815,8374062,-41625938,0.16748124,2002,death to smoochy2002
5088,the believer,1500000,406035,1840248,340248,1.226832,2002,the believer2002
2289,possession,25000000,10103647,14805812,-10194188,0.59223248,2002,possession2002
2286,abandon,25000000,10719367,12219367,-12780633,0.48877468,2002,abandon2002
5082,nueve reinas,1500000,1222889,12412889,10912889,8.275259333333333,2002,nueve reinas2002
1556,spy kids 2 the island of lost dreams,38000000,85846296,119721296,81721296,3.1505604210526315,2002,spy kids 2 the island of lost dreams2002
204,die another day,142000000,160942139,431942139,289942139,3.0418460492957746,2002,die another day2002
1352,high crimes,42000000,41543207,63781100,21781100,1.5185976190476191,2002,high crimes2002
3348,barbershop,12000000,75781642,77063461,65063461,6.421955083333334,2002,barbershop2002
778,the santa clause 2,65000000,139225854,172825854,107825854,2.6588592923076924,2002,the santa clause 22002
2843,the salton sea,18000000,676698,676698,-17323302,0.037594333333333334,2002,the salton sea2002
3022,big fat liar,15000000,47811275,52461017,37461017,3.4974011333333332,2002,big fat liar2002
410,gangs of new york,97000000,77730500,183124621,86124621,1.8878826907216495,2002,gangs of new york2002
1894,like mike,30000000,51432423,62432423,32432423,2.0810807666666666,2002,like mike2002
712,we were soldiers,70000000,78120196,114658262,44658262,1.6379751714285715,2002,we were soldiers2002
1093,mr deeds,50000000,126293452,171269535,121269535,3.4253907,2002,mr deeds2002
5022,el crimen de padre amaro,1800000,5719000,5719000,3919000,3.1772222222222224,2002,el crimen de padre amaro2002
753,the sum of all fears,68000000,118471320,193500000,125500000,2.8455882352941178,2002,the sum of all fears2002
2253,punchdrunk love,25000000,17791031,24591031,-408969,0.98364124,2002,punchdrunk love2002
1130,unfaithful,50000000,52752475,119114494,69114494,2.38228988,2002,unfaithful2002
697,xxx,70000000,141930000,267200000,197200000,3.817142857142857,2002,xxx2002
895,the tuxedo,60000000,50586000,104429625,44429625,1.74049375,2002,the tuxedo2002
2213,undercover brother,25000000,38230435,40796145,15796145,1.6318458,2002,undercover brother2002
4209,sunshine state,5600000,3064356,3281898,-2318102,0.5860532142857143,2002,sunshine state2002
2112,formula 51,27000000,5204007,5204007,-21795993,0.192741,2002,formula 512002
2271,stealing harvard,25000000,13973532,13973532,-11026468,0.55894128,2002,stealing harvard2002
4304,y tu mamã tambiãn,5000000,13649881,33649881,28649881,6.7299762,2002,y tu mamã tambiãn2002
517,collateral damage,85000000,40048332,78353508,-6646492,0.9218059764705883,2002,collateral damage2002
518,showtime,85000000,37948765,78948765,-6051235,0.928809,2002,showtime2002
525,scoobydoo,84000000,153294164,276294164,192294164,3.289216238095238,2002,scoobydoo2002
4679,martin lawrence live runteldat,3000000,19184820,19184820,16184820,6.39494,2002,martin lawrence live runteldat2002
2261,half past dead,25000000,15567860,19233280,-5766720,0.7693312,2002,half past dead2002
4129,national lampoonâs van wilder,6000000,21305259,39241323,33241323,6.5402205,2002,national lampoonâs van wilder2002
773,ice age,65000000,176387405,386116343,321116343,5.940251430769231,2002,ice age2002
3234,far from heaven,13500000,15901849,29027914,15527914,2.150215851851852,2002,far from heaven2002
2788,orange county,18000000,41059716,43308707,25308707,2.406039277777778,2002,orange county2002
363,harry potter and the chamber of secrets,100000000,262233381,879225135,779225135,8.79225135,2002,harry potter and the chamber of secrets2002
2565,ghost ship,20000000,30113491,68349884,48349884,3.4174942,2002,ghost ship2002
3494,frailty,11000000,13110448,19947280,8947280,1.8133890909090908,2002,frailty2002
4184,lucky break,6000000,54606,4316497,-1683503,0.7194161666666666,2002,lucky break2002
1161,murder by numbers,50000000,31874869,56643267,6643267,1.13286534,2002,murder by numbers2002
1914,blue crush,30000000,40118420,51618420,21618420,1.720614,2002,blue crush2002
1066,catch me if you can,52000000,164606800,355612291,303612291,6.838697903846154,2002,catch me if you can2002
3203,jason x,14000000,13121555,16951798,2951798,1.2108427142857143,2002,jason x2002
426,the lord of the rings the two towers,94000000,342548984,934699645,840699645,9.94361324468085,2002,the lord of the rings the two towers2002
743,ballistic ecks vs sever,70000000,14294842,14294842,-55705158,0.20421202857142856,2002,ballistic ecks vs sever2002
2092,the divine secrets of the yaya sisterhood,27000000,69586544,73826768,46826768,2.7343247407407407,2002,the divine secrets of the yaya sisterhood2002
2989,wasabi,15300000,81525,7000000,-8300000,0.45751633986928103,2002,wasabi2002
1870,about schmidt,30000000,65005217,107054484,77054484,3.5684828,2002,about schmidt2002
4512,secretary,4000000,4046737,9413956,5413956,2.353489,2002,secretary2002
360,minority report,102000000,132024714,358824714,256824714,3.5178893529411766,2002,minority report2002
4508,the rules of attraction,4000000,6525762,11799060,7799060,2.949765,2002,the rules of attraction2002
732,i spy,70000000,33561137,60279822,-9720178,0.8611403142857142,2002,i spy2002
691,signs,70702619,227969295,408269295,337566676,5.774457874042827,2002,signs2002
4548,sonny,4000000,17639,17639,-3982361,0.00440975,2002,sonny2002
396,treasure planet,100000000,38120554,91800000,-8200000,0.918,2002,treasure planet2002
733,bad company,70000000,30157016,69157016,-842984,0.9879573714285714,2002,bad company2002
404,the adventures of pluto nash,100000000,4411102,7094995,-92905005,0.07094995,2002,the adventures of pluto nash2002
3108,the importance of being earnest,15000000,8378141,8378141,-6621859,0.5585427333333334,2002,the importance of being earnest2002
545,lilo  stitch,80000000,145771527,245800000,165800000,3.0725,2002,lilo  stitch2002
4177,morvern callar,6000000,267194,267194,-5732806,0.044532333333333333,2002,morvern callar2002
1986,trapped,30000000,6916869,6916869,-23083131,0.2305623,2002,trapped2002
4229,harvard man,5500000,56653,56653,-5443347,0.010300545454545455,2002,harvard man2002
4923,full frontal,2000000,2512846,3438804,1438804,1.719402,2002,full frontal2002
2207,the hours,25000000,41675994,97030468,72030468,3.88121872,2002,the hours2002
2983,juwanna mann,15600000,13571817,13771817,-1828183,0.8828087820512821,2002,juwanna mann2002
1960,eight legged freaks,30000000,17266505,36722311,6722311,1.2240770333333333,2002,eight legged freaks2002
4247,my big fat greek wedding,5000000,241438208,374890034,369890034,74.9780068,2002,my big fat greek wedding2002
2882,40 days and 40 nights,17000000,37939782,95092667,78092667,5.593686294117647,2002,40 days and 40 nights2002
850,the bourne identity,60000000,121468960,214357371,154357371,3.57262285,2002,the bourne identity2002
3151,all the queens men,15000000,22723,22723,-14977277,0.0015148666666666667,2002,all the queens men2002
999,maid in manhattan,55000000,93932896,163838217,108838217,2.9788766727272726,2002,maid in manhattan2002
2210,the wild thornberrys movie,25000000,40108697,60694737,35694737,2.42778948,2002,the wild thornberrys movie2002
474,k19 the widowmaker,90000000,35168966,65716126,-24283874,0.7301791777777777,2002,k19 the widowmaker2002
2965,hollywood ending,16000000,4839383,14839383,-1160617,0.9274614375,2002,hollywood ending2002
2895,wes craven presents they,17000000,12840842,16140842,-859158,0.949461294117647,2002,wes craven presents they2002
859,two weeks notice,60000000,93354918,199043309,139043309,3.317388483333333,2002,two weeks notice2002
861,the scorpion king,60000000,90580000,165890634,105890634,2.7648439,2002,the scorpion king2002
3138,metropolis,15000000,673414,1405032,-13594968,0.0936688,2002,metropolis2002
4879,elling,2100000,313436,313436,-1786564,0.1492552380952381,2002,elling2002
4256,jackass the movie,5000000,64282312,79282312,74282312,15.8564624,2002,jackass the movie2002
740,rollerball,70000000,18990542,25852508,-44147492,0.36932154285714286,2002,rollerball2002
4595,empire,3500000,17504595,18495444,14995444,5.284412571428572,2002,empire2002
556,road to perdition,80000000,104054514,183354514,103354514,2.291931425,2002,road to perdition2002
4674,bowling for columbine,3000000,21576018,58240487,55240487,19.413495666666666,2002,bowling for columbine2002
825,austin powers in goldmember,63000000,213117789,296338663,233338663,4.703788301587301,2002,austin powers in goldmember2002
1170,blood work,50000000,26199517,26199517,-23800483,0.52399034,2002,blood work2002
2098,about a boy,27000000,40803000,130759651,103759651,4.842950037037037,2002,about a boy2002
3071,tuck everlasting,15000000,19161999,19344615,4344615,1.289641,2002,tuck everlasting2002
2025,serving sara,29000000,16930185,20146150,-8853850,0.6946948275862069,2002,serving sara2002
927,dragonfly,60000000,30063805,30063805,-29936195,0.5010634166666667,2002,dragonfly2002
923,analyze that,60000000,32122249,54994757,-5005243,0.9165792833333334,2002,analyze that2002
4705,real women have curves,3000000,5853194,7777790,4777790,2.5925966666666667,2002,real women have curves2002
2935,the master of disguise,16000000,40363530,40363530,24363530,2.522720625,2002,the master of disguise2002
582,the time machine,80000000,56684819,98983590,18983590,1.237294875,2002,the time machine2002
3092,knockaround guys,15000000,11660180,12419700,-2580300,0.82798,2002,knockaround guys2002
909,reign of fire,60000000,43061982,82150183,22150183,1.3691697166666668,2002,reign of fire2002
613,red dragon,78000000,92955420,206455420,128455420,2.646864358974359,2002,red dragon2002
2138,clockstoppers,26000000,36985501,38788828,12788828,1.491878,2002,clockstoppers2002
574,spirit stallion of the cimarron,80000000,73215310,106515310,26515310,1.331441375,2002,spirit stallion of the cimarron2002
4719,thirteen conversations about one thing,3000000,3287435,3705923,705923,1.2353076666666667,2002,thirteen conversations about one thing2002
2951,white oleander,16000000,16357770,21657770,5657770,1.353610625,2002,white oleander2002
4428,25th hour,4500000,13084595,25344490,20844490,5.632108888888889,2002,25th hour2002
4449,mean machine,4500000,92723,92723,-4407277,0.020605111111111112,2002,mean machine2002
3192,all about the benjamins,14000000,25482931,25873145,11873145,1.8480817857142857,2002,all about the benjamins2002
2026,confessions of a dangerous mind,29000000,16007718,33013805,4013805,1.1384070689655172,2002,confessions of a dangerous mind2002
3047,halloween resurrection,15000000,30259652,37659652,22659652,2.5106434666666666,2002,halloween resurrection2002
2985,ararat,15500000,1693000,1693000,-13807000,0.10922580645161291,2002,ararat2002
3191,jonah a veggietales movie,14000000,25571351,25608779,11608779,1.8291985,2002,jonah a veggietales movie2002
1047,eye see you,55000000,79161,1807990,-53192010,0.03287254545454545,2002,eye see you2002
1049,blade 2,54000000,81676888,154338601,100338601,2.858122240740741,2002,blade 22002
908,star trek nemesis,60000000,43254409,67312826,7312826,1.1218804333333334,2002,star trek nemesis2002
3577,calendar girls,10000000,31011616,93074616,83074616,9.3074616,2003,calendar girls2003
4234,irreversible,5400000,792200,8133256,2733256,1.5061585185185185,2003,irreversible2003
1029,stuck on you,55000000,33832741,63537164,8537164,1.1552211636363636,2003,stuck on you2003
1027,the hunted,55000000,34234008,47213095,-7786905,0.858419909090909,2003,the hunted2003
993,american wedding,55000000,104354205,126425115,71425115,2.2986384545454546,2003,american wedding2003
1007,kill bill volume 1,55000000,70098138,176469428,121469428,3.2085350545454547,2003,kill bill volume 12003
3144,steal canadian release,15000000,220944,220944,-14779056,0.0147296,2003,steal canadian release2003
3143,buffalo soldiers,15000000,353743,353743,-14646257,0.023582866666666667,2003,buffalo soldiers2003
1940,dumb and dumberer when harry met lloyd,30000000,26214846,26214846,-3785154,0.8738282,2003,dumb and dumberer when harry met lloyd2003
4268,monster,5000000,34469210,64240813,59240813,12.8481626,2003,monster2003
1517,duplex,40000000,9652000,10070651,-29929349,0.251766275,2003,duplex2003
1855,mystic river,30000000,90135191,156822020,126822020,5.227400666666667,2003,mystic river2003
4055,gerry,7000000,254683,719699,-6280301,0.10281414285714285,2003,gerry2003
1736,the order,35000000,7659747,11559747,-23440253,0.3302784857142857,2003,the order2003
3684,spider,10000000,1641788,1641788,-8358212,0.1641788,2003,spider2003
3642,dirty pretty things,10000000,8112414,14156753,4156753,1.4156753,2003,dirty pretty things2003
3401,girl with a pearl earring,12000000,11634362,43274797,31274797,3.606233083333333,2003,girl with a pearl earring2003
3416,from justin to kelly,12000000,4922166,4922166,-7077834,0.4101805,2003,from justin to kelly2003
3617,wrong turn,10000000,15417771,28649556,18649556,2.8649556,2003,wrong turn2003
2072,winged migration,28000000,11689053,39134983,11134983,1.3976779642857142,2003,winged migration2003
932,sinbad legend of the seven seas,60000000,26483452,80767884,20767884,1.3461314,2003,sinbad legend of the seven seas2003
3419,in the cut,12000000,4717455,23693646,11693646,1.9744705,2003,in the cut2003
1168,basic,50000000,26599248,42598498,-7401502,0.85196996,2003,basic2003
3130,the company,15000000,2281585,3396508,-11603492,0.22643386666666668,2003,the company2003
1911,secondhand lions,30000000,42070939,47902566,17902566,1.5967522,2003,secondhand lions2003
3474,phone booth,11000000,46566212,97837138,86837138,8.894285272727272,2003,phone booth2003
4201,foolproof,5800000,230312,421021,-5378979,0.0725898275862069,2003,foolproof2003
4197,lauberge espagnole,5900000,3895664,3895664,-2004336,0.6602820338983051,2003,lauberge espagnole2003
1075,bulletproof monk,52000000,23010607,23010607,-28989393,0.4425116730769231,2003,bulletproof monk2003
4178,the flower of evil,6000000,181798,181798,-5818202,0.030299666666666666,2003,the flower of evil2003
4165,shattered glass,6000000,2207975,3456602,-2543398,0.5761003333333333,2003,shattered glass2003
1097,how to lose a guy in 10 days,50000000,105807520,178890782,128890782,3.57781564,2003,how to lose a guy in 10 days2003
4134,a mighty wind,6000000,17583468,18504539,12504539,3.0840898333333335,2003,a mighty wind2003
3224,amen,14000000,274299,274299,-13725701,0.019592785714285715,2003,amen2003
977,anger management,56000000,135560942,195660942,139660942,3.493945392857143,2003,anger management2003
1122,shanghai knights,50000000,60470220,88316835,38316835,1.7663367,2003,shanghai knights2003
4095,nowhere in africa,6500000,6173485,6173485,-326515,0.9497669230769231,2003,nowhere in africa2003
1054,gigli,54000000,6087542,7126002,-46873998,0.131963,2003,gigli2003
4220,mambo italiano,5500000,9282750,12399772,6899772,2.254504,2003,mambo italiano2003
1039,gods and generals,55000000,12882934,12923936,-42076064,0.23498065454545455,2003,gods and generals2003
4225,wonderland,5500000,1060512,1060512,-4439488,0.19282036363636362,2003,wonderland2003
3102,dark blue,15000000,9237470,12262065,-2737935,0.817471,2003,dark blue2003
3107,boat trip,15000000,8586376,14933713,-66287,0.9955808666666667,2003,boat trip2003
949,beyond borders,60000000,4426297,11427090,-48572910,0.1904515,2003,beyond borders2003
4324,les invasions barbares,5000000,8460000,25913869,20913869,5.1827738,2003,les invasions barbares2003
1969,alex  emma,30000000,14208384,15358583,-14641417,0.5119527666666667,2003,alex  emma2003
1148,out of time,50000000,41083108,55489826,5489826,1.10979652,2003,out of time2003
1613,a man apart,36000000,26500000,43797731,7797731,1.2166036388888888,2003,a man apart2003
1183,the life of david gale,50000000,19694635,28920188,-21079812,0.57840376,2003,the life of david gale2003
1657,radio,35000000,52333738,53293628,18293628,1.5226750857142857,2003,radio2003
2051,identity,28000000,52131264,82183683,54183683,2.9351315357142855,2003,identity2003
853,the italian job,60000000,106126012,176262839,116262839,2.9377139833333334,2003,the italian job2003
918,intolerable cruelty,60000000,35327628,121327628,61327628,2.0221271333333335,2003,intolerable cruelty2003
3039,malibus most wanted,15000000,34308901,34499204,19499204,2.2999469333333336,2003,malibus most wanted2003
4372,tycoon,5000000,121016,121016,-4878984,0.0242032,2003,tycoon2003
4502,the cooler,4000000,8291572,11131455,7131455,2.78286375,2003,the cooler2003
3091,confidence,15000000,12212417,12212417,-2787583,0.8141611333333333,2003,confidence2003
4442,spun,4500000,410241,1022649,-3477351,0.22725533333333334,2003,spun2003
1993,the good thief,30000000,3517797,6460758,-23539242,0.2153586,2003,the good thief2003
4478,lost in translation,4000000,44585453,117085297,113085297,29.27132425,2003,lost in translation2003
4464,whale rider,4300000,20779666,39374600,35074600,9.156883720930233,2003,whale rider2003
4447,lilja 4ever,4500000,181655,4556982,56982,1.0126626666666667,2003,lilja 4ever2003
810,the missing,65000000,26900336,38253433,-26746567,0.5885143538461538,2003,the missing2003
877,kangaroo jack,60000000,66723216,90723216,30723216,1.5120536,2003,kangaroo jack2003
794,mona lisa smile,65000000,63803100,141205169,76205169,2.1723872153846155,2003,mona lisa smile2003
2018,once upon a time in mexico,29000000,56330657,97413527,68413527,3.3590871379310343,2003,once upon a time in mexico2003
4539,mondays in the sun,4000000,146402,146402,-3853598,0.0366005,2003,mondays in the sun2003
4526,poolhall junkies,4000000,563711,563711,-3436289,0.14092775,2003,poolhall junkies2003
3026,the lizzie mcguire movie,15000000,42734455,55534455,40534455,3.702297,2003,the lizzie mcguire movie2003
2011,ripleys game,30000000,0,0,-30000000,0.0,2003,ripleys game2003
4556,nothing,4000000,0,63180,-3936820,0.015795,2003,nothing2003
890,paycheck,60000000,53789313,98819789,38819789,1.6469964833333333,2003,paycheck2003
4513,the real cancun,4000000,3816594,3816594,-183406,0.9541485,2003,the real cancun2003
854,daddy day care,60000000,104148781,164285587,104285587,2.7380931166666667,2003,daddy day care2003
4360,party monster,5000000,742898,894030,-4105970,0.178806,2003,party monster2003
3503,the guru,11000000,3051221,24150550,13150550,2.1955045454545457,2003,the guru2003
3501,the gospel of john,11000000,4068087,4234355,-6765645,0.3849413636363636,2003,the gospel of john2003
3693,owning mahowny,10000000,1011054,1011054,-8988946,0.1011054,2003,owning mahowny2003
1742,luther,35000000,5781086,32717063,-2282937,0.9347732285714285,2003,luther2003
3793,chasing papi,9000000,6126237,12657377,3657377,1.4063752222222223,2003,chasing papi2003
4020,house of the dead,7000000,10199354,13860078,6860078,1.9800111428571427,2003,house of the dead2003
4018,house of 1000 corpses,7000000,12634962,17005466,10005466,2.4293522857142857,2003,house of 1000 corpses2003
1255,scary movie 3,45000000,110000082,155200000,110200000,3.448888888888889,2003,scary movie 32003
1277,love actually,45000000,59472278,248505300,203505300,5.52234,2003,love actually2003
3995,darkness falls,7000000,32539681,47289758,40289758,6.755679714285714,2003,darkness falls2003
1622,head of state,35200000,37788228,38283765,3083765,1.0876069602272727,2003,head of state2003
1296,johnny english,45000000,28013509,163126676,118126676,3.6250372444444445,2003,johnny english2003
4057,the heart of me,7000000,196067,196067,-6803933,0.02800957142857143,2003,the heart of me2003
3949,swimming pool,7800000,10130108,24021282,16221282,3.0796515384615386,2003,swimming pool2003
1788,elf,32000000,173840591,220678483,188678483,6.89620259375,2003,elf2003
1372,the medallion,41000000,22108977,22108977,-18891023,0.5392433414634147,2003,the medallion2003
3868,28 days laterâ,8000000,45064915,82955633,74955633,10.369454125,2003,28 days laterâ2003
1381,cheaper by the dozen,40000000,138614544,190212113,150212113,4.755302825,2003,cheaper by the dozen2003
1386,spy kids 3d game over,40000000,111760631,167851995,127851995,4.196299875,2003,spy kids 3d game over2003
3809,the legend of suriyothai,9000000,454255,454255,-8545745,0.050472777777777776,2003,the legend of suriyothai2003
1422,gothika,40000000,59588068,141484812,101484812,3.5371203,2003,gothika2003
3921,the singing detective,8000000,336456,524747,-7475253,0.065593375,2003,the singing detective2003
3968,masked and anonymous,7500000,533344,555335,-6944665,0.07404466666666666,2003,masked and anonymous2003
3197,my bosss daughter,14000000,15549702,15549702,1549702,1.110693,2003,my bosss daughter2003
2890,dickie roberts former child star,17000000,22734486,23734486,6734486,1.3961462352941176,2003,dickie roberts former child star2003
758,dreamcatcher,68000000,33685268,75685268,7685268,1.1130186470588235,2003,dreamcatcher2003
4644,cidade de deus,3300000,7563397,32059295,28759295,9.714937878787879,2003,cidade de deus2003
2116,the statement,27000000,765637,1545064,-25454936,0.05722459259259259,2003,the statement2003
5749,manito,25000,0,0,-25000,0.0,2003,manito2003
5460,the slaughter rule,500000,13134,13134,-486866,0.026268,2003,the slaughter rule2003
5064,cabin fever,1500000,21158188,30351664,28851664,20.234442666666666,2003,cabin fever2003
5433,the station agent,500000,5801558,9470209,8970209,18.940418,2003,the station agent2003
222,hulk,137000000,132177234,245075434,108075434,1.7888717810218977,2003,hulk2003
5262,all the real girls,1000000,549666,703020,-296980,0.70302,2003,all the real girls2003
2211,rugrats go wild,25000000,39402572,55443032,30443032,2.21772128,2003,rugrats go wild2003
4932,the book of mormon movie volume 1 the journey,2000000,1660865,1660865,-339135,0.8304325,2003,the book of mormon movie volume 1 the journey2003
229,master and commander the far side of the world,135000000,93926386,212912137,77912137,1.5771269407407407,2003,master and commander the far side of the world2003
2863,city of ghosts,17500000,325491,325491,-17174509,0.018599485714285713,2003,city of ghosts2003
2218,what a girl wants,25000000,35990505,35990505,10990505,1.4396202,2003,what a girl wants2003
2219,jeepers creepers ii,25000000,35623801,119923801,94923801,4.79695204,2003,jeepers creepers ii2003
2222,cradle 2 the grave,25000000,34657731,56434942,31434942,2.25739768,2003,cradle 2 the grave2003
5250,bubba hotep,1000000,1239183,1492895,492895,1.492895,2003,bubba hotep2003
2687,marci x,20000000,1646664,1646664,-18353336,0.0823332,2003,marci x2003
2333,old school,24000000,75155000,86765463,62765463,3.615227625,2003,old school2003
2837,anything else,18000000,3203044,13203044,-4796956,0.7335024444444445,2003,anything else2003
247,bad boys ii,130000000,138540870,273271982,143271982,2.1020921692307692,2003,bad boys ii2003
4914,thirteen,2000000,4601043,9505996,7505996,4.752998,2003,thirteen2003
5572,better luck tomorrow,250000,3802390,3809226,3559226,15.236904,2003,better luck tomorrow2003
5200,dracula pages from a virgins diary,1100000,39659,81371,-1018629,0.07397363636363637,2003,dracula pages from a virgins diary2003
5678,the work and the story,103000,16137,16137,-86863,0.15666990291262137,2003,the work and the story2003
703,swat,70000000,116877597,207154748,137154748,2.959353542857143,2003,swat2003
4207,bend it like beckham,5600000,32543449,74566042,68966042,13.315364642857142,2003,bend it like beckham2003
5441,the rm,500000,1111615,1111615,611615,2.22323,2003,the rm2003
655,tears of the sun,75000000,43632458,85632458,10632458,1.1417661066666667,2003,tears of the sun2003
5448,civil brand,500000,254293,254293,-245707,0.508586,2003,civil brand2003
5540,tupac resurrection,300000,7718961,7808524,7508524,26.028413333333333,2003,tupac resurrection2003
119,terminator 3 rise of the machines,170000000,150358296,433058296,263058296,2.5474017411764707,2003,terminator 3 rise of the machines2003
2133,final destination 2,26000000,46896664,90396664,64396664,3.4767947692307692,2003,final destination 22003
5757,steel spirit,20000,0,0,-20000,0.0,2003,steel spirit2003
716,big fish,70000000,66432867,123954323,53954323,1.7707760428571429,2003,big fish2003
2493,bringing down the house,20000000,132675402,164675402,144675402,8.2337701,2003,bringing down the house2003
2512,holes,20000000,67383924,71232214,51232214,3.5616107,2003,holes2003
615,the league of extraordinary gentlemen,78000000,66465204,179265204,101265204,2.2982718461538463,2003,the league of extraordinary gentlemen2003
2414,underworld,22000000,51970690,95708457,73708457,4.350384409090909,2003,underworld2003
5754,flywheel,20000,0,0,-20000,0.0,2003,flywheel2003
2128,open range,26000000,58331254,68613992,42613992,2.638999692307692,2003,open range2003
5458,the journey,500000,19800,19800,-480200,0.0396,2003,the journey2003
2955,how to deal,16000000,14108518,14108518,-1891482,0.881782375,2003,how to deal2003
2528,the jungle book 2,20000000,47901582,140122225,120122225,7.00611125,2003,the jungle book 22003
2505,school of rock,20000000,81261177,131944672,111944672,6.5972336,2003,school of rock2003
622,2 fast 2 furious,76000000,127120058,236410607,160410607,3.110665881578947,2003,2 fast 2 furious2003
5542,pieces of april,300000,2528664,3571253,3271253,11.904176666666666,2003,pieces of april2003
664,hollywood homicide,75000000,30207785,50409753,-24590247,0.67213004,2003,hollywood homicide2003
425,the lord of the rings the return of the king,94000000,377845905,1141403341,1047403341,12.142588734042553,2003,the lord of the rings the return of the king2003
2120,freaky friday,26000000,110222438,160822438,134822438,6.185478384615385,2003,freaky friday2003
424,finding nemo,94000000,380529370,936429370,842429370,9.962014574468085,2003,finding nemo2003
2923,house of sand and fog,16500000,13005485,16157923,-342077,0.9792680606060606,2003,house of sand and fog2003
522,the core,85000000,31111260,74132631,-10867369,0.8721486,2003,the core2003
5366,the young unknowns,800000,58163,58163,-741837,0.07270375,2003,the young unknowns2003
4826,sur le seuil,2500000,2013052,2013052,-486948,0.8052208,2003,sur le seuil2003
2169,legally blonde 2 red white  blonde,25000000,90639088,125339088,100339088,5.01356352,2003,legally blonde 2 red white  blonde2003
2783,under the tuscan sun,18000000,43601508,57490024,39490024,3.193890222222222,2003,under the tuscan sun2003
4905,les triplettes de belleville,2000000,7301288,17403168,15403168,8.701584,2003,les triplettes de belleville2003
5271,the battle of shaker heights,1000000,280351,839145,-160855,0.839145,2003,the battle of shaker heights2003
460,the haunted mansion,90000000,75817994,155750628,65750628,1.7305625333333334,2003,the haunted mansion2003
2662,willard,20000000,6882696,6882696,-13117304,0.3441348,2003,willard2003
536,bruce almighty,81000000,242704995,484468608,403468608,5.981093925925926,2003,bruce almighty2003
464,lara croft tomb raider the cradle of life,90000000,65653758,157092943,67092943,1.7454771444444444,2003,lara croft tomb raider the cradle of life2003
213,the last samurai,140000000,111110575,456810575,316810575,3.2629326785714285,2003,the last samurai2003
486,seabiscuit,86000000,120277854,148715342,62715342,1.7292481627906977,2003,seabiscuit2003
5305,the partys over,1000000,0,0,-1000000,0.0,2003,the partys over2003
4831,my life without me,2500000,432360,12267275,9767275,4.90691,2003,my life without me2003
512,the rundown,85000000,47641743,80831893,-4168107,0.9509634470588235,2003,the rundown2003
5360,raising victor vargas,800000,2073984,2900578,2100578,3.6257225,2003,raising victor vargas2003
2908,veronica guerin,17000000,1569918,9438074,-7561926,0.5551808235294118,2003,veronica guerin2003
205,pirates of the caribbean the curse of the black pearl,140000000,305411224,634954103,494954103,4.53538645,2003,pirates of the caribbean the curse of the black pearl2003
265,xmen 2,125000000,214949694,406875536,281875536,3.255004288,2003,xmen 22003
2172,freddy vs jason,25000000,82622655,114576403,89576403,4.58305612,2003,freddy vs jason2003
600,timeline,80000000,19480739,26703184,-53296816,0.3337898,2003,timeline2003
552,somethings gotta give,80000000,124685242,266685242,186685242,3.333565525,2003,somethings gotta give2003
2883,good boy,17000000,37667746,45312217,28312217,2.665424529411765,2003,good boy2003
5174,down  out with the dolls,1200000,58936,58936,-1141064,0.049113333333333335,2003,down  out with the dolls2003
2729,just married,19000000,56127162,101564935,82564935,5.345522894736842,2003,just married2003
176,the matrix revolutions,150000000,139270910,427300260,277300260,2.8486684,2003,the matrix revolutions2003
290,charlies angels full throttle,120000000,100814328,227200000,107200000,1.8933333333333333,2003,charlies angels full throttle2003
4960,this thing of ours,2000000,37227,37227,-1962773,0.0186135,2003,this thing of ours2003
5140,the hebrew hammer,1300000,77755,90213,-1209787,0.06939461538461539,2003,the hebrew hammer2003
5006,northfork,1900000,1420578,1445140,-454860,0.7606,2003,northfork2003
5035,may,1750000,145540,634803,-1115197,0.3627445714285714,2003,may2003
343,the cat in the hat,109000000,101018283,133818283,24818283,1.2276906697247707,2003,the cat in the hat2003
2791,honey,18000000,30272254,62646763,44646763,3.480375722222222,2003,honey2003
2704,people i know,20000000,121972,5694213,-14305787,0.28471065,2003,people i know2003
5266,blue car,1000000,464126,475367,-524633,0.475367,2003,blue car2003
2774,bad santa,18000000,60060328,77147031,59147031,4.285946166666666,2003,bad santa2003
2198,agent cody banks,25000000,47545060,58240458,33240458,2.32961832,2003,agent cody banks2003
558,daredevil,80000000,102543518,182782518,102782518,2.284781475,2003,daredevil2003
4909,american splendor,2000000,6003587,8685632,6685632,4.342816,2003,american splendor2003
159,the matrix reloaded,150000000,281553689,738576929,588576929,4.9238461933333335,2003,the matrix reloaded2003
2616,a guy thing,20000000,15543862,17430594,-2569406,0.8715297,2003,a guy thing2003
2612,21 grams,20000000,16248701,59667625,39667625,2.98338125,2003,21 grams2003
562,cold mountain,80000000,95632614,165173909,85173909,2.0646738625,2003,cold mountain2003
4726,dysfunktional family,3000000,2255000,2255000,-745000,0.7516666666666667,2003,dysfunktional family2003
598,looney tunes back in action,80000000,20950820,54540662,-25459338,0.681758275,2003,looney tunes back in action2003
4729,elephant,3000000,1266955,10051516,7051516,3.3505053333333334,2003,elephant2003
2961,the cookout,16000000,11540112,11540112,-4459888,0.721257,2004,the cookout2004
868,man on fire,60000000,77906816,130968579,70968579,2.18280965,2004,man on fire2004
634,shark tale,75000000,161412000,371917043,296917043,4.958893906666667,2004,shark tale2004
1115,garfield the movie,50000000,75367693,208094550,158094550,4.161891,2004,garfield the movie2004
1116,christmas with the kranks,50000000,73701902,96469187,46469187,1.92938374,2004,christmas with the kranks2004
4977,freeze frame,2000000,0,105377,-1894623,0.0526885,2004,freeze frame2004
1120,the forgotten,50000000,66711892,117211892,67211892,2.34423784,2004,the forgotten2004
638,50 first dates,75000000,120776832,196320329,121320329,2.6176043866666667,2004,50 first dates2004
2821,being julia,18000000,7739049,14488705,-3511295,0.8049280555555556,2004,being julia2004
394,catwoman,100000000,40202379,82145379,-17854621,0.82145379,2004,catwoman2004
2159,the passion of the christ,25000000,370782930,622341924,597341924,24.89367696,2004,the passion of the christ2004
4912,before sunset,2000000,5792822,11217346,9217346,5.608673,2004,before sunset2004
2871,sideways,17000000,71502303,109793192,92793192,6.45842305882353,2004,sideways2004
1018,the phantom of the opera,55000000,51225796,153770052,98770052,2.7958191272727273,2004,the phantom of the opera2004
1010,kill bill volume 2,55000000,66207920,153535982,98535982,2.791563309090909,2004,kill bill volume 22004
4356,the machinist,5000000,1082044,8655397,3655397,1.7310794,2004,the machinist2004
1992,the merchant of venice,30000000,3765585,18765585,-11234415,0.6255195,2004,the merchant of venice2004
578,the manchurian candidate,80000000,65948711,96148711,16148711,1.2018588875,2004,the manchurian candidate2004
4335,la mala educaciã³n,5000000,5211842,40311842,35311842,8.0623684,2004,la mala educaciã³n2004
1876,friday night lights,30000000,61255921,61950770,31950770,2.0650256666666666,2004,friday night lights2004
2957,soul plane,16000000,13922211,14553807,-1446193,0.9096129375,2004,soul plane2004
1881,without a paddle,30000000,58156435,65121280,35121280,2.1707093333333334,2004,without a paddle2004
2230,anacondas the hunt for the blood orchid,25000000,31526393,70326393,45326393,2.81305572,2004,anacondas the hunt for the blood orchid2004
5507,napoleon dynamite,400000,44540956,46122713,45722713,115.3067825,2004,napoleon dynamite2004
4704,woman thou art loosed,3000000,6879730,6879730,3879730,2.2932433333333333,2004,woman thou art loosed2004
1980,first daughter,30000000,9055010,10419084,-19580916,0.3473028,2004,first daughter2004
799,blade trinity,65000000,52397389,131353165,66353165,2.020817923076923,2004,blade trinity2004
5512,tarnation,400000,592014,1162014,762014,2.905035,2004,tarnation2004
120,van helsing,170000000,120150546,300150546,130150546,1.7655914470588234,2004,van helsing2004
3637,sleepover,10000000,9408183,9408183,-591817,0.9408183,2004,sleepover2004
2384,vanity fair,23000000,16123851,19123851,-3876149,0.8314717826086957,2004,vanity fair2004
1853,million dollar baby,30000000,100492203,231928227,201928227,7.7309409,2004,million dollar baby2004
5181,grand theft parsons,1200000,0,0,-1200000,0.0,2004,grand theft parsons2004
2772,barbershop 2 back in business,18000000,65070412,65842412,47842412,3.6579117777777777,2004,barbershop 2 back in business2004
1937,the prince  me,30000000,28165882,29356757,-643243,0.9785585666666666,2004,the prince  me2004
874,ladder 49,60000000,74541707,102332848,42332848,1.7055474666666666,2004,ladder 492004
2135,in good company,26000000,45489752,63489752,37489752,2.4419135384615385,2004,in good company2004
4419,the assassination of richard nixon,4600000,708776,4880143,280143,1.060900652173913,2004,the assassination of richard nixon2004
883,hellboy,60000000,59623958,99823958,39823958,1.6637326333333333,2004,hellboy2004
4224,les choristes,5500000,3629758,83529758,78029758,15.187228727272727,2004,les choristes2004
614,hidalgo,78000000,67286731,108086731,30086731,1.3857273205128204,2004,hidalgo2004
1043,thunderbirds,55000000,6768055,28231444,-26768556,0.5132989818181818,2004,thunderbirds2004
2860,hotel rwanda,17500000,23519128,36521223,19021223,2.0869270285714285,2004,hotel rwanda2004
2217,beauty shop,25000000,36351350,38351350,13351350,1.534054,2004,beauty shop2004
1044,un long dimanche de fianãailles,55000000,6167817,69759296,14759296,1.2683508363636364,2004,un long dimanche de fianãailles2004
432,the incredibles,92000000,261441092,614726752,522726752,6.681812521739131,2004,the incredibles2004
616,exorcist the beginning,78000000,41814863,43957541,-34042459,0.563558217948718,2004,exorcist the beginning2004
4915,touching the void,2000000,4593598,15396525,13396525,7.6982625,2004,touching the void2004
4804,riding giants,2600000,2276368,3292333,692333,1.266281923076923,2004,riding giants2004
2024,seed of chucky,29000000,17016190,24716190,-4283810,0.8522824137931034,2004,seed of chucky2004
2145,welcome to mooseport,26000000,14469428,14469428,-11530572,0.5565164615384616,2004,welcome to mooseport2004
1149,bridget jones the edge of reason,50000000,40203020,263894551,213894551,5.27789102,2004,bridget jones the edge of reason2004
863,starsky  hutch,60000000,88200225,170200225,110200225,2.8366704166666667,2004,starsky  hutch2004
4080,remember me my love,6700000,223878,223878,-6476122,0.03341462686567164,2004,remember me my love2004
3242,mar adentro,13300000,2086345,39686345,26386345,2.9839357142857144,2004,mar adentro2004
1858,spongebob squarepants the movie,30000000,85416609,142051255,112051255,4.735041833333334,2004,spongebob squarepants the movie2004
1154,raising helen,50000000,37485528,49928680,-71320,0.9985736,2004,raising helen2004
4105,good bye lenin,6400000,4063859,79384539,72984539,12.40383421875,2004,good bye lenin2004
2268,the girl next door,25000000,14589444,31635150,6635150,1.265406,2004,the girl next door2004
1174,the life aquatic with steve zissou,50000000,24006726,34806726,-15193274,0.69613452,2004,the life aquatic with steve zissou2004
1860,the notebook,30000000,81001787,116025023,86025023,3.8675007666666668,2004,the notebook2004
367,national treasure,100000000,173005002,331323410,231323410,3.3132341,2004,national treasure2004
3251,the butterfly effect,13000000,57924679,95638592,82638592,7.356814769230769,2004,the butterfly effect2004
645,the terminal,75000000,77073959,218673959,143673959,2.9156527866666666,2004,the terminal2004
3051,confessions of a teenage drama queen,15000000,29331068,33118854,18118854,2.2079236,2004,confessions of a teenage drama queen2004
4101,a home at the end of the world,6500000,1029017,1033810,-5466190,0.1590476923076923,2004,a home at the end of the world2004
374,lemony snickets a series of unfortunate events,100000000,118627117,212956024,112956024,2.12956024,2004,lemony snickets a series of unfortunate events2004
347,i robot,105000000,144801023,348629585,243629585,3.320281761904762,2004,i robot2004
2254,eurotrip,25000000,17718223,20718223,-4281777,0.82872892,2004,eurotrip2004
4078,shade,6800000,25032,9533964,2733964,1.4020535294117646,2004,shade2004
386,the stepford wives,100000000,59475623,96221971,-3778029,0.96221971,2004,the stepford wives2004
336,home on the range,110000000,50026353,76482461,-33517539,0.6952951,2004,home on the range2004
2594,yugioh,20000000,19762690,28762690,8762690,1.4381345,2004,yugioh2004
1173,twisted,50000000,25195050,40119848,-9880152,0.80239696,2004,twisted2004
4814,garden state,2500000,26782316,36028802,33528802,14.4115208,2004,garden state2004
2809,catch that kid,18000000,16703799,16959614,-1040386,0.9422007777777778,2004,catch that kid2004
4114,fahrenheit 911,6000000,119114517,221148959,215148959,36.85815983333333,2004,fahrenheit 9112004
4323,saved,5000000,8886160,10206551,5206551,2.0413102,2004,saved2004
4305,shaun of the dead,5000000,13542874,30332385,25332385,6.066477,2004,shaun of the dead2004
1970,wicker park,30000000,13001257,21577076,-8422924,0.7192358666666666,2004,wicker park2004
2170,scoobydoo 2 monsters unleashed,25000000,84185387,181185387,156185387,7.24741548,2004,scoobydoo 2 monsters unleashed2004
2171,anchorman the legend of ron burgundy,25000000,84136909,89476265,64476265,3.5790506,2004,anchorman the legend of ron burgundy2004
1133,resident evil apocalypse,50000000,50740078,125168734,75168734,2.50337468,2004,resident evil apocalypse2004
1968,godsend,30000000,14334645,16910708,-13089292,0.5636902666666667,2004,godsend2004
1964,the whole ten yards,30000000,16323969,26323969,-3676031,0.8774656333333334,2004,the whole ten yards2004
2904,bobby jones stroke of genius,17000000,2694071,2694071,-14305929,0.15847476470588234,2004,bobby jones stroke of genius2004
490,the bourne supremacy,85000000,176087450,311001124,226001124,3.6588367529411765,2004,the bourne supremacy2004
3496,kinsey,11000000,10214647,17443529,6443529,1.5857753636363636,2004,kinsey2004
2142,agent cody banks 2 destination london,26000000,23514247,28703083,2703083,1.1039647307692309,2004,agent cody banks 2 destination london2004
4374,decoys,5000000,84733,96760,-4903240,0.019352,2004,decoys2004
3142,the return,15000000,501752,5953886,-9046114,0.3969257333333333,2004,the return2004
471,king arthur,90000000,51877963,203877963,113877963,2.2653107,2004,king arthur2004
3084,delovely,15000000,13337299,18524496,3524496,1.2349664,2004,delovely2004
1950,little black book,30000000,20422207,21758371,-8241629,0.7252790333333333,2004,little black book2004
1947,mr 3000,30000000,21800302,21827296,-8172704,0.7275765333333334,2004,mr 30002004
2193,finding neverland,25000000,51676606,115036108,90036108,4.60144432,2004,finding neverland2004
4416,camping sauvage,4600000,3479302,3479302,-1120698,0.75637,2004,camping sauvage2004
2877,jet lis hero,17000000,53652140,177535958,160535958,10.443291647058823,2004,jet lis hero2004
974,after the sunset,57000000,28328132,38329114,-18670886,0.6724405964912281,2004,after the sunset2004
979,walking tall,56000000,46213824,47313824,-8686176,0.8448897142857142,2004,walking tall2004
1718,wimbledon,35000000,16862585,41666476,6666476,1.1904707428571428,2004,wimbledon2004
1706,ella enchanted,35000000,22913677,22913677,-12086323,0.6546764857142857,2004,ella enchanted2004
1511,alfie,40000000,13395939,35195939,-4804061,0.879898475,2004,alfie2004
1847,dodgeball a true underdog story,30000000,114326736,167791704,137791704,5.5930568,2004,dodgeball a true underdog story2004
4036,veerzaara,7000000,2938532,7017859,17859,1.0025512857142858,2004,veerzaara2004
857,collateral,60000000,100170152,217670152,157670152,3.6278358666666666,2004,collateral2004
296,the chronicles of riddick,120000000,57712751,107212751,-12787249,0.8934395916666666,2004,the chronicles of riddick2004
5156,saw,1200000,55968727,103880027,102680027,86.56668916666666,2004,saw2004
657,spanglish,75000000,42044321,54344321,-20655679,0.7245909466666667,2004,spanglish2004
1260,the princess diaries 2 royal engagement,45000000,95149435,122071435,77071435,2.7126985555555554,2004,the princess diaries 2 royal engagement2004
269,the day after tomorrow,125000000,186740799,556319450,431319450,4.4505556,2004,the day after tomorrow2004
2731,a cinderella story,19000000,51438175,70164105,51164105,3.6928476315789474,2004,a cinderella story2004
1818,george and the dragon,32000000,0,0,-32000000,0.0,2004,george and the dragon2004
2709,the touch,20000000,0,5918742,-14081258,0.2959371,2004,the touch2004
1286,fat albert,45000000,48114556,48563556,3563556,1.0791901333333334,2004,fat albert2004
1294,cellular,45000000,32003620,61475984,16475984,1.3661329777777778,2004,cellular2004
666,flight of the phoenix,75000000,21009180,34009180,-40990820,0.45345573333333333,2004,flight of the phoenix2004
3971,code 46,7500000,197148,1788324,-5711676,0.2384432,2004,code 462004
1808,laws of attraction,32000000,17848322,29948322,-2051678,0.9358850625,2004,laws of attraction2004
3965,the work and the glory,7500000,3347647,3347647,-4152353,0.4463529333333333,2004,the work and the glory2004
2683,bon voyage,20000000,2353728,8361736,-11638264,0.4180868,2004,bon voyage2004
238,harry potter and the prisoner of azkaban,130000000,249757726,796907323,666907323,6.13005633076923,2004,harry potter and the prisoner of azkaban2004
4655,maria full of grace,3200000,6529624,14441158,11241158,4.512861875,2004,maria full of grace2004
842,meet the fockers,60000000,279167575,516567575,456567575,8.609459583333333,2004,meet the fockers2004
1199,the big bounce,50000000,6471394,6626115,-43373885,0.1325223,2004,the big bounce2004
5123,incident at loch ness,1400000,36830,56073,-1343927,0.040052142857142856,2004,incident at loch ness2004
2768,mean girls,18000000,86047227,130953026,112953026,7.275168111111111,2004,mean girls2004
322,oceans twelve,110000000,125531634,362989076,252989076,3.299900690909091,2004,oceans twelve2004
3653,teachers pet the movie,10000000,6491969,6491969,-3508031,0.6491969,2004,teachers pet the movie2004
2656,connie  carla,20000000,8047525,8047525,-11952475,0.40237625,2004,connie  carla2004
5274,guiana 1838,1000000,227241,227241,-772759,0.227241,2004,guiana 18382004
4496,what the  do we know,4000000,10941801,10941801,6941801,2.73545025,2004,what the  do we know2004
2044,miracle,28000000,64378093,64474705,36474705,2.302668035714286,2004,miracle2004
1775,the punisher,33000000,33664370,54533774,21533774,1.652538606060606,2004,the punisher2004
2360,beyond the sea,24000000,6144806,8292914,-15707086,0.34553808333333336,2004,beyond the sea2004
3098,raise your voice,15000000,10411980,14811980,-188020,0.9874653333333333,2004,raise your voice2004
3827,the i inside,8800000,0,0,-8800000,0.0,2004,the i inside2004
3847,silmido,8500000,298347,30298347,21798347,3.564511411764706,2004,silmido2004
1346,along came polly,42000000,88073507,173044410,131044410,4.120105,2004,along came polly2004
3843,club dread,8500000,5001655,7573551,-926449,0.891006,2004,club dread2004
5348,latter days,850000,833118,865708,15708,1.01848,2004,latter days2004
1425,shall we dance,40000000,57887882,118097882,78097882,2.95244705,2004,shall we dance2004
688,two brothers,72000000,19176754,62176754,-9823246,0.8635660277777778,2004,two brothers2004
5365,the mudge boy,800000,62544,62544,-737456,0.07818,2004,the mudge boy2004
3788,breakin all the rules,9000000,12232382,12512317,3512317,1.3902574444444444,2004,breakin all the rules2004
3371,johnson family vacation,12000000,31203964,31286759,19286759,2.607229916666667,2004,johnson family vacation2004
2649,superbabies baby geniuses 2,20000000,9109322,9355369,-10644631,0.46776845,2004,superbabies baby geniuses 22004
2354,win a date with tad hamilton,24000000,16980098,16980098,-7019902,0.7075040833333334,2004,win a date with tad hamilton2004
2672,birth,20000000,5005899,14603001,-5396999,0.73015005,2004,birth2004
3334,tae guik gi the brotherhood of war,12500000,1110186,69826708,57326708,5.58613664,2004,tae guik gi the brotherhood of war2004
1407,ray,40000000,75305995,124823094,84823094,3.12057735,2004,ray2004
3870,you got served,8000000,40066497,50811858,42811858,6.35148225,2004,you got served2004
2110,suspect zero,27000000,8712564,8712564,-18287436,0.32268755555555556,2004,suspect zero2004
2389,chasing liberty,23000000,12189514,12291975,-10708025,0.5344336956521739,2004,chasing liberty2004
1595,13 going on 30,37000000,57139723,97658712,60658712,2.6394246486486486,2004,13 going on 302004
5517,fabled,400000,31425,31425,-368575,0.0785625,2004,fabled2004
3404,house of flying daggers,12000000,11050094,92863945,80863945,7.738662083333334,2004,house of flying daggers2004
117,the polar express,170000000,187224605,311365187,141365187,1.8315599235294118,2004,the polar express2004
1440,secret window,40000000,47958031,92111551,52111551,2.302788775,2004,secret window2004
181,troy,150000000,133298577,484161265,334161265,3.2277417666666666,2004,troy2004
326,the aviator,110000000,102608827,208370892,98370892,1.8942808363636363,2004,the aviator2004
3722,eulogy,10000000,70527,70527,-9929473,0.0070527,2004,eulogy2004
2627,envy,20000000,13548322,14566246,-5433754,0.7283123,2004,envy2004
3703,the brown bunny,10000000,366301,630427,-9369573,0.0630427,2004,the brown bunny2004
5776,the mongol king,7000,900,900,-6100,0.12857142857142856,2004,the mongol king2004
5430,open water,500000,30500882,55518641,55018641,111.037282,2004,open water2004
2615,paparazzi,20000000,15712072,16612072,-3387928,0.8306036,2004,paparazzi2004
689,the village,71682975,114197520,257641634,185958659,3.594181658894598,2004,the village2004
692,shrek 2,70000000,441226247,937008132,867008132,13.385830457142857,2004,shrek 22004
150,alexander,155000000,34297191,167297191,12297191,1.0793367161290321,2004,alexander2004
1494,torque,40000000,21176322,46176322,6176322,1.15440805,2004,torque2004
5439,osama,500000,1127331,1971479,1471479,3.942958,2004,osama2004
3391,my babys daddy,12000000,17321573,17322212,5322212,1.4435176666666667,2004,my babys daddy2004
5443,mean creek,500000,603951,1348750,848750,2.6975,2004,mean creek2004
1509,new york minute,40000000,14018364,21215882,-18784118,0.53039705,2004,new york minute2004
5371,saints and soldiers,780000,1310470,1310470,530470,1.6800897435897435,2004,saints and soldiers2004
3702,shaolin soccer,10000000,488872,42776032,32776032,4.2776032,2004,shaolin soccer2004
5774,primer,7000,424760,841926,834926,120.27514285714285,2004,primer2004
3707,imaginary heroes,10000000,228524,290875,-9709125,0.0290875,2004,imaginary heroes2004
5768,on the downlow,10000,1987,1987,-8013,0.1987,2004,on the downlow2004
3781,harold  kumar go to white castle,9000000,18225165,18225165,9225165,2.025018333333333,2004,harold  kumar go to white castle2004
4638,lincomparable mademoiselle c,3400000,493905,493905,-2906095,0.14526617647058823,2004,lincomparable mademoiselle c2004
2438,i heart huckabees,22000000,12784713,20034713,-1965287,0.9106687727272728,2004,i heart huckabees2004
2558,team america world police,20000000,32774834,50948811,30948811,2.54744055,2004,team america world police2004
1700,jersey girl,35000000,25266129,37066129,2066129,1.0590322571428572,2004,jersey girl2004
2553,eternal sunshine of the spotless mind,20000000,34366518,72570762,52570762,3.6285381,2004,eternal sunshine of the spotless mind2004
5621,short cut to nirvana kumbh mela,200000,381225,439651,239651,2.198255,2004,short cut to nirvana kumbh mela2004
5635,samantha an american girl holiday,200000,0,0,-200000,0.0,2004,samantha an american girl holiday2004
1551,against the ropes,39000000,5881504,6429865,-32570135,0.16486833333333334,2004,against the ropes2004
1681,closer,35000000,33987757,116177695,81177695,3.3193627142857145,2004,closer2004
49,spiderman 2,200000000,373524485,795110670,595110670,3.97555335,2004,spiderman 22004
5627,malevolence,200000,126021,346106,146106,1.73053,2004,malevolence2004
730,sky captain and the world of tomorrow,70000000,37760080,49730854,-20269146,0.7104407714285714,2004,sky captain and the world of tomorrow2004
710,avp alien vs predator,70000000,80281096,172543519,102543519,2.4649074142857144,2004,avp alien vs predator2004
5687,the lost skeleton of cadavra,100000,110536,110536,10536,1.10536,2004,the lost skeleton of cadavra2004
1670,the ladykillers,35000000,39692139,77392139,42392139,2.2112039714285716,2004,the ladykillers2004
2510,white chicks,20000000,69148997,111448997,91448997,5.57244985,2004,white chicks2004
3537,the grudge,10000000,110359362,187281115,177281115,18.7281115,2004,the grudge2004
5709,super size me,65000,11529368,22233808,22168808,342.05858461538463,2004,super size me2004
3529,the blue butterfly,10400000,1610194,1610194,-8789806,0.15482634615384616,2004,the blue butterfly2004
3523,darkness,10600000,22163442,34409206,23809206,3.2461515094339624,2004,darkness2004
1535,the last shot,40000000,463730,463730,-39536270,0.01159325,2004,the last shot2004
3502,vera drake,11000000,3753806,13353855,2353855,1.213986818181818,2004,vera drake2004
1265,monsterinlaw,45000000,82931301,155931301,110931301,3.465140022222222,2005,monsterinlaw2005
1132,syriana,50000000,50824620,92690959,42690959,1.85381918,2005,syriana2005
1053,elizabethtown,54000000,26850426,50719373,-3280627,0.9392476481481481,2005,elizabethtown2005
166,batman begins,150000000,205343774,359142722,209142722,2.3942848133333334,2005,batman begins2005
1121,herbie fully loaded,50000000,66010682,144110682,94110682,2.88221364,2005,herbie fully loaded2005
163,charlie and the chocolate factory,150000000,206459076,475825484,325825484,3.1721698933333333,2005,charlie and the chocolate factory2005
158,harry potter and the goblet of fire,150000000,290201752,897099794,747099794,5.980665293333334,2005,harry potter and the goblet of fire2005
1112,the ring two,50000000,75941727,161941727,111941727,3.23883454,2005,the ring two2005
214,fun with dick and jane,140000000,110550000,203018919,63018919,1.4501351357142858,2005,fun with dick and jane2005
1056,the dukes of hazzard,53000000,80270227,109848461,56848461,2.0726124716981134,2005,the dukes of hazzard2005
809,zathura,65000000,28045540,58545540,-6454460,0.9007006153846154,2005,zathura2005
402,son of the mask,100000000,17018422,59918422,-40081578,0.59918422,2005,son of the mask2005
585,the legend of zorro,80000000,45575336,141475336,61475336,1.7684417,2005,the legend of zorro2005
581,bewitched,80000000,63313159,131159306,51159306,1.639491325,2005,bewitched2005
2195,hide and seek,25000000,51100486,123696741,98696741,4.94786964,2005,hide and seek2005
550,robots,80000000,128200012,260700012,180700012,3.25875015,2005,robots2005
2303,kings ransom,25000000,4008527,4049527,-20950473,0.16198108,2005,kings ransom2005
2212,the sisterhood of the traveling pants,25000000,39053061,41560117,16560117,1.66240468,2005,the sisterhood of the traveling pants2005
2300,the worlds fastest indian,25000000,5128124,18991288,-6008712,0.75965152,2005,the worlds fastest indian2005
589,the brothers grimm,80000000,37899638,105299638,25299638,1.316245475,2005,the brothers grimm2005
2298,underclassman,25000000,5654777,5654777,-19345223,0.22619108,2005,underclassman2005
2281,the lords of dogtown,25000000,11273517,13424365,-11575635,0.5369746,2005,the lords of dogtown2005
2418,derailed,22000000,36020063,57520063,35520063,2.6145483181818183,2005,derailed2005
2313,venom,25000000,881745,881745,-24118255,0.0352698,2005,venom2005
1898,racing stripes,30000000,49772522,89955540,59955540,2.998518,2005,racing stripes2005
945,the great raid,60000000,10166502,10597070,-49402930,0.17661783333333334,2005,the great raid2005
1151,the adventures of sharkboy and lavagirl in 3d,50000000,39177684,69425966,19425966,1.38851932,2005,the adventures of sharkboy and lavagirl in 3d2005
509,memoirs of a geisha,85000000,57010853,161510853,76510853,1.9001276823529412,2005,memoirs of a geisha2005
1971,the new world,30000000,12712093,26184400,-3815600,0.8728133333333333,2005,the new world2005
1982,an unfinished life,30000000,8535575,18535575,-11464425,0.6178525,2005,an unfinished life2005
933,dark water,60000000,25473093,49473093,-10526907,0.82455155,2005,dark water2005
178,chicken little,150000000,135386665,310043823,160043823,2.06695882,2005,chicken little2005
2364,the bridge of san luis rey,24000000,49981,1696765,-22303235,0.07069854166666667,2005,the bridge of san luis rey2005
2361,hauru no ugoku shiro,24000000,4710455,237814327,213814327,9.908930291666668,2005,hauru no ugoku shiro2005
1994,supercross,30000000,3102550,3252550,-26747450,0.10841833333333334,2005,supercross2005
2014,walk the line,29000000,119519402,187707495,158707495,6.4726722413793105,2005,walk the line2005
898,miss congeniality 2 armed and fabulous,60000000,48478006,101382396,41382396,1.6897066,2005,miss congeniality 2 armed and fabulous2005
2031,the jacket,28500000,6301131,15452978,-13047022,0.5422097543859649,2005,the jacket2005
1951,assault on precinct 13,30000000,20040895,36040895,6040895,1.2013631666666666,2005,assault on precinct 132005
202,sahara,145000000,68671925,121671925,-23328075,0.839116724137931,2005,sahara2005
930,xxx state of the union,60000000,26873932,71073932,11073932,1.1845655333333334,2005,xxx state of the union2005
2058,pride  prejudice,28000000,38372662,126549607,98549607,4.519628821428571,2005,pride  prejudice2005
1001,flightplan,55000000,89706988,214392904,159392904,3.8980528,2005,flightplan2005
1034,aeon flux,55000000,25857987,53913573,-1086427,0.9802467818181818,2005,aeon flux2005
1866,four brothers,30000000,74494381,92494381,62494381,3.083146033333333,2005,four brothers2005
1193,domino,50000000,10169202,23574057,-26425943,0.47148114,2005,domino2005
1185,into the blue,50000000,18782227,41982227,-8017773,0.83964454,2005,into the blue2005
1182,man of the house,50000000,19699706,22099706,-27900294,0.44199412,2005,man of the house2005
1884,wallace  gromit the curse of the wererabbit,30000000,56068547,197593152,167593152,6.5864384,2005,wallace  gromit the curse of the wererabbit2005
2425,deuce bigalow european gigolo,22000000,22400154,45273464,23273464,2.0578847272727274,2005,deuce bigalow european gigolo2005
1886,corpse bride,30000000,53359111,114770654,84770654,3.8256884666666666,2005,corpse bride2005
818,oliver twist,65000000,2070920,26670920,-38329080,0.41032184615384615,2005,oliver twist2005
2241,ice princess,25000000,24381334,25732334,732334,1.02929336,2005,ice princess2005
1284,the hitchhikers guide to the galaxy,45000000,51019112,102746214,57746214,2.2832492,2005,the hitchhikers guide to the galaxy2005
484,fantastic four,87500000,154696080,333132750,245632750,3.8072314285714284,2005,fantastic four2005
1665,must love dogs,35000000,43894863,58405313,23405313,1.6687232285714286,2005,must love dogs2005
1684,the bad news bears,35000000,32868349,33500620,-1499380,0.9571605714285715,2005,the bad news bears2005
1408,sin city,40000000,74103820,158527918,118527918,3.96319795,2005,sin city2005
1713,cursed,35000000,19294901,25114901,-9885099,0.7175686,2005,cursed2005
1711,valiant,35000000,19478106,64188387,29188387,1.8339539142857142,2005,valiant2005
1549,serenity,39000000,25514517,40319440,1319440,1.0338317948717948,2005,serenity2005
82,the chronicles of narnia the lion the witch and the wardrobe,180000000,291710957,720539572,540539572,4.002997622222222,2005,the chronicles of narnia the lion the witch and the wardrobe2005
1473,get rich or die tryin,40000000,30981850,46666955,6666955,1.166673875,2005,get rich or die tryin2005
1799,the transporter 2,32000000,43095856,88978458,56978458,2.7805768125,2005,the transporter 22005
1337,danny the dog,43000000,24537621,49037621,6037621,1.1404097906976745,2005,danny the dog2005
1478,rent,40000000,29077547,31670620,-8329380,0.7917655,2005,rent2005
1375,wedding crashers,40000000,209218368,283218368,243218368,7.0804592,2005,wedding crashers2005
1450,fever pitch,40000000,42071069,50071069,10071069,1.251776725,2005,fever pitch2005
1805,a history of violence,32000000,31493782,61477797,29477797,1.92118115625,2005,a history of violence2005
1360,lord of war,42000000,24149632,60437727,18437727,1.4389935,2005,lord of war2005
1441,the skeleton key,40000000,47907715,92256918,52256918,2.30642295,2005,the skeleton key2005
1282,yours mine and ours,45000000,53359917,72359917,27359917,1.6079981555555556,2005,yours mine and ours2005
1643,guess who,35000000,68915888,102115888,67115888,2.9175968,2005,guess who2005
1283,kicking and screaming,45000000,52842724,55842724,10842724,1.2409494222222222,2005,kicking and screaming2005
1967,the cave,30000000,15007991,27147991,-2852009,0.9049330333333333,2005,the cave2005
1646,sky high,35000000,63939454,83109359,48109359,2.3745531142857144,2005,sky high2005
1307,the producers the movie musical,45000000,19398532,32952995,-12047005,0.7322887777777778,2005,the producers the movie musical2005
1309,rebound,45000000,16809014,17492014,-27507986,0.3887114222222222,2005,rebound2005
1804,dreamer inspired by a true story,32000000,33022286,39498360,7498360,1.23432375,2005,dreamer inspired by a true story2005
2446,the libertine,22000000,4835065,9448623,-12551377,0.4294828636363636,2005,the libertine2005
2264,the greatest game ever played,25000000,15331289,15468266,-9531734,0.61873064,2005,the greatest game ever played2005
1271,coach carter,45000000,67264877,76665507,31665507,1.7036779333333334,2005,coach carter2005
482,cinderella man,88000000,61649911,105021488,17021488,1.193426,2005,cinderella man2005
462,the interpreter,90000000,72708161,162753837,72753837,1.8083759666666666,2005,the interpreter2005
532,the longest yard,82000000,158119460,191558505,109558505,2.336079329268293,2005,the longest yard2005
811,elektra,65000000,24409722,56824633,-8175367,0.8742251230769231,2005,elektra2005
607,a sound of thunder,80000000,1900451,6300451,-73699549,0.0787556375,2005,a sound of thunder2005
2314,where the truth lies,25000000,872142,1415656,-23584344,0.05662624,2005,where the truth lies2005
220,stealth,138000000,32116746,76416746,-61583254,0.553744536231884,2005,stealth2005
235,war of the worlds,132000000,234280354,606836535,474836535,4.597246477272727,2005,war of the worlds2005
734,doom,70000000,28212337,58757178,-11242822,0.8393882571428571,2005,doom2005
725,rumor has it,70000000,42996140,88933562,18933562,1.270479457142857,2005,rumor has it2005
2107,the honeymooners,27000000,12834849,13174426,-13825574,0.4879417037037037,2005,the honeymooners2005
2247,a lot like love,25000000,21835784,41921590,16921590,1.6768636,2005,a lot like love2005
2114,mindhunters,27000000,4476235,16566235,-10433765,0.6135642592592593,2005,mindhunters2005
2121,the 40 yearold virgin,26000000,109449237,177344230,151344230,6.820931923076923,2005,the 40 yearold virgin2005
338,kingdom of heaven,110000000,47398413,218853353,108853353,1.9895759363636363,2005,kingdom of heaven2005
2129,red eye,26000000,57891803,96666486,70666486,3.717941769230769,2005,red eye2005
652,munich,75000000,47379090,131492772,56492772,1.75323696,2005,munich2005
304,star wars ep iii revenge of the sith,115000000,380270577,848998877,733998877,7.382598930434782,2005,star wars ep iii revenge of the sith2005
651,be cool,75000000,55849401,94944017,19944017,1.2659202266666667,2005,be cool2005
646,constantine,75000000,75976178,221594911,146594911,2.9545988133333334,2005,constantine2005
317,mr and mrs smith,110000000,186336279,486124090,376124090,4.419309909090909,2005,mr and mrs smith2005
632,madagascar,75000000,193595521,556559566,481559566,7.420794213333333,2005,madagascar2005
2157,the constant gardener,25500000,33579798,86301599,60801599,3.384376431372549,2005,the constant gardener2005
662,hostage,75000000,34636443,77636443,2636443,1.0351525733333333,2005,hostage2005
685,jarhead,72000000,62647540,96947540,24947540,1.3464936111111112,2005,jarhead2005
961,just like heaven,58000000,48318130,100687083,42687083,1.7359841896551724,2005,just like heaven2005
865,cheaper by the dozen 2,60000000,82571173,135015330,75015330,2.2502555,2005,cheaper by the dozen 22005
1956,north country,30000000,18324242,23676771,-6323229,0.7892257,2005,north country2005
3119,los tres entierros de melquiades estrada,15000000,5027684,13454474,-1545526,0.8969649333333334,2005,los tres entierros de melquiades estrada2005
5739,funny ha ha,30000,77070,82698,52698,2.7566,2005,funny ha ha2005
2503,are we there yet,20000000,82674398,98114471,78114471,4.90572355,2005,are we there yet2005
4620,debs,3500000,96793,96793,-3403207,0.027655142857142857,2005,debs2005
2773,the family stone,18000000,60062868,92357499,74357499,5.130972166666667,2005,the family stone2005
5139,neal n nikki,1300000,100358,329621,-970379,0.2535546153846154,2005,neal n nikki2005
4028,bride  prejudice,7000000,6601079,25269040,18269040,3.6098628571428573,2005,bride  prejudice2005
5071,the squid and the whale,1500000,7372734,11191423,9691423,7.460948666666667,2005,the squid and the whale2005
2770,the exorcism of emily rose,18000000,75072454,144529078,126529078,8.029393222222222,2005,the exorcism of emily rose2005
3430,2046,12000000,1442338,19287485,7287485,1.6072904166666666,2005,20462005
3122,kiss kiss bang bang,15000000,4235837,16829464,1829464,1.1219642666666667,2005,kiss kiss bang bang2005
5704,peace propaganda and the promised land,70000,4930,4930,-65070,0.07042857142857142,2005,peace propaganda and the promised land2005
2757,the amityville horror,18500000,65233369,109175673,90675673,5.90138772972973,2005,the amityville horror2005
2531,boogeyman,20000000,46752382,67192859,47192859,3.35964295,2005,boogeyman2005
5628,side effects,200000,44701,44701,-155299,0.223505,2005,side effects2005
2755,george a romeros land of the dead,18975000,20700082,47751015,28776015,2.5165225296442686,2005,george a romeros land of the dead2005
3610,roll bounce,10000000,17380866,17433072,7433072,1.7433072,2005,roll bounce2005
4828,saving face,2500000,1187266,1269705,-1230295,0.507882,2005,saving face2005
3432,duma,12000000,870067,994790,-11005210,0.08289916666666666,2005,duma2005
4097,layer cake,6500000,2339957,11745931,5245931,1.8070663076923077,2005,layer cake2005
2585,2 for the money,20000000,22991379,30491379,10491379,1.52456895,2005,2 for the money2005
4215,diary of a mad black woman,5500000,50406346,50458356,44958356,9.174246545454546,2005,diary of a mad black woman2005
5085,the ballad of jack and rose,1500000,712294,1126258,-373742,0.7508386666666667,2005,the ballad of jack and rose2005
4941,inside deep throat,2000000,691880,691880,-1308120,0.34594,2005,inside deep throat2005
5631,solitude,200000,6260,6260,-193740,0.0313,2005,solitude2005
5242,junebug,1000000,2678010,3553253,2553253,3.553253,2005,junebug2005
3548,white noise,10000000,56094360,92094360,82094360,9.209436,2005,white noise2005
5121,the holy girl,1400000,304124,1261792,-138208,0.90128,2005,the holy girl2005
984,hitch,55000000,177784257,366784257,311784257,6.668804672727273,2005,hitch2005
4875,chicken tikka masala,2160000,0,37865,-2122135,0.017530092592592594,2005,chicken tikka masala2005
4634,la marche de lempereur,3400000,77437223,133276359,129876359,39.19892911764706,2005,la marche de lempereur2005
4785,hustle  flow,2800000,22202809,23591783,20791783,8.425636785714286,2005,hustle  flow2005
4731,oldboy,3000000,707391,6239723,3239723,2.0799076666666667,2005,oldboy2005
3045,the wedding date,15000000,31726995,47175038,32175038,3.1450025333333333,2005,the wedding date2005
4522,mirrormask,4000000,864959,973613,-3026387,0.24340325,2005,mirrormask2005
5555,fighting tommy riley,300000,10514,10514,-289486,0.035046666666666663,2005,fighting tommy riley2005
3623,broken flowers,10000000,13744960,40744960,30744960,4.074496,2005,broken flowers2005
5547,first morning,300000,87264,87264,-212736,0.29088,2005,first morning2005
5102,forty shades of blue,1500000,75828,172569,-1327431,0.115046,2005,forty shades of blue2005
5722,the call of cthulhu,50000,0,0,-50000,0.0,2005,the call of cthulhu2005
3625,the matador,10000000,12589255,17300838,7300838,1.7300838,2005,the matador2005
4782,high tension,2850000,3681066,6435262,3585262,2.2579866666666666,2005,high tension2005
4011,the devils rejects,7000000,17044981,20940428,13940428,2.991489714285714,2005,the devils rejects2005
5529,murderball,350000,1531154,1772979,1422979,5.065654285714285,2005,murderball2005
5521,show me,400000,0,0,-400000,0.0,2005,show me2005
5518,the dark hours,400000,423,423,-399577,0.0010575,2005,the dark hours2005
5779,return to the land of wonders,5000,1338,1338,-3662,0.2676,2005,return to the land of wonders2005
4378,fascination,5000000,16670,83356,-4916644,0.0166712,2005,fascination2005
5580,november,250000,191862,191862,-58138,0.767448,2005,november2005
5585,on the outs,250000,49772,237816,-12184,0.951264,2005,on the outs2005
3613,the perfect man,10000000,16535005,19535005,9535005,1.9535005,2005,the perfect man2005
4754,my big fat independent movie,3000000,4655,4655,-2995345,0.0015516666666666667,2005,my big fat independent movie2005
4077,the chumscrubber,6800000,49526,49526,-6750474,0.007283235294117647,2005,the chumscrubber2005
2634,the weather man,20000000,12482775,15466961,-4533039,0.77334805,2005,the weather man2005
5108,walmart the high cost of low price,1500000,0,58692,-1441308,0.039128,2005,walmart the high cost of low price2005
5046,yes,1700000,396035,661221,-1038779,0.3889535294117647,2005,yes2005
5463,the californians,500000,4134,4134,-495866,0.008268,2005,the californians2005
4520,thumbsucker,4000000,1328679,1919197,-2080803,0.47979925,2005,thumbsucker2005
4251,saw ii,5000000,87025093,152925093,147925093,30.5850186,2005,saw ii2005
5190,waiting,1125000,16124543,18673274,17548274,16.59846577777778,2005,waiting2005
4418,dear frankie,4600000,1340891,3099369,-1500631,0.6737758695652174,2005,dear frankie2005
5057,dil jo bhi kahey,1600000,129319,129319,-1470681,0.080824375,2005,dil jo bhi kahey2005
4244,saint ralph,5200000,795126,1695126,-3504874,0.3259857692307692,2005,saint ralph2005
3388,the upside of anger,12000000,18761993,28915761,16915761,2.40964675,2005,the upside of anger2005
5060,i love your work,1600000,3264,3264,-1596736,0.00204,2005,i love your work2005
5193,wolf creek,1100000,16186348,29005064,27905064,26.36824,2005,wolf creek2005
4918,me and you and everyone we know,2000000,3885134,9615464,7615464,4.807732,2005,me and you and everyone we know2005
2608,kung fu hustle,20000000,17104669,102034104,82034104,5.1017052,2005,kung fu hustle2005
5194,ongbak,1100000,4563167,24062965,22962965,21.875422727272728,2005,ongbak2005
4226,de battre mon coeur sest arrãªtã,5500000,1023424,8589831,3089831,1.5617874545454546,2005,de battre mon coeur sest arrãªtã2005
2698,the game of their lives,20000000,375474,375474,-19624526,0.0187737,2005,the game of their lives2005
3062,match point,15000000,23089926,87973835,72973835,5.864922333333333,2005,match point2005
5432,mad hot ballroom,500000,8117961,9387581,8887581,18.775162,2005,mad hot ballroom2005
2697,steamboy,20000000,468867,10468867,-9531133,0.52344335,2005,steamboy2005
2602,poohs heffalump movie,20000000,18098433,55686944,35686944,2.7843472,2005,poohs heffalump movie2005
5380,undead,750000,41196,229250,-520750,0.30566666666666664,2005,undead2005
5781,my date with drew,1100,181041,181041,179941,164.58272727272728,2005,my date with drew2005
4189,1114,6000000,0,0,-6000000,0.0,2005,11142005
978,the pacifier,56000000,113006880,198006880,142006880,3.535837142857143,2005,the pacifier2005
3997,good night and good luck,7000000,31501218,56586901,49586901,8.083843,2005,good night and good luck2005
5474,insomnia manica,500000,0,0,-500000,0.0,2005,insomnia manica2005
4099,the work and the glory american zion,6500000,2025032,2025032,-4474968,0.3115433846153846,2005,the work and the glory american zion2005
5026,travellers and magicians,1800000,506793,1322161,-477839,0.7345338888888889,2005,travellers and magicians2005
4946,house of d,2000000,388532,466106,-1533894,0.233053,2005,house of d2005
4953,its all gone pete tong,2000000,120620,2226603,226603,1.1133015,2005,its all gone pete tong2005
2640,mrs henderson presents,20000000,11036366,27836366,7836366,1.3918183,2005,mrs henderson presents2005
3961,shopgirl,7500000,10284523,11758418,4258418,1.5677890666666667,2005,shopgirl2005
3936,welcome to dongmakgol,8000000,0,48000000,40000000,6.0,2005,welcome to dongmakgol2005
5389,rize,700000,3278611,4857731,4157731,6.939615714285714,2005,rize2005
3806,undiscovered,9000000,1069318,1069318,-7930682,0.1188131111111111,2005,undiscovered2005
3934,dear wendy,8000000,23106,446438,-7553562,0.05580475,2005,dear wendy2005
5505,gory gory hallelujah,425000,12604,12604,-412396,0.029656470588235295,2005,gory gory hallelujah2005
5295,the helixâloaded,1000000,3700,3700,-996300,0.0037,2005,the helixâloaded2005
5045,my summer of love,1700000,1000915,4727375,3027375,2.7808088235294117,2005,my summer of love2005
2671,alone in the dark,20000000,5178569,10588079,-9411921,0.52940395,2005,alone in the dark2005
3906,cachã,8000000,3647381,19891331,11891331,2.486416375,2005,cachã2005
2973,the white countess,16000000,1669971,2814566,-13185434,0.175910375,2005,the white countess2005
2653,the man,20000000,8330720,10393696,-9606304,0.5196848,2005,the man2005
2987,madison,15500000,517262,517262,-14982738,0.033371741935483874,2005,madison2005
3229,brokeback mountain,13900000,83043761,176980863,163080863,12.732436187050359,2005,brokeback mountain2005
3238,der untergang,13500000,5501940,93631744,80131744,6.935684740740741,2005,der untergang2005
5282,chocolate deep dark secrets,1000000,49000,1549000,549000,1.549,2005,chocolate deep dark secrets2005
2660,proof,20000000,7535331,8284331,-11715669,0.41421655,2005,proof2005
5307,proud,1000000,0,0,-1000000,0.0,2005,proud2005
3998,capote,7000000,28750530,49924079,42924079,7.132011285714285,2005,capote2005
5222,cry wolf,1000000,10047674,15943081,14943081,15.943081,2005,cry wolf2005
3159,dungeons  dragons wrath of the dragon god,15000000,0,909822,-14090178,0.0606548,2005,dungeons  dragons wrath of the dragon god2005
3044,because of winndixie,15000000,32647042,33508485,18508485,2.233899,2005,because of winndixie2005
1780,goal the dream begins,33000000,4283255,27610873,-5389127,0.8366931212121212,2006,goal the dream begins2006
3892,see no evil,8000000,15032800,18828036,10828036,2.3535045,2006,see no evil2006
3857,kurtlar vadisi  irak,8300000,0,24906717,16606717,3.000809277108434,2006,kurtlar vadisi  irak2006
935,the black dahlia,60000000,22672813,49238525,-10761475,0.8206420833333333,2006,the black dahlia2006
3865,little miss sunshine,8000000,59891098,100642353,92642353,12.580294125,2006,little miss sunshine2006
4331,grandmaâs boy,5000000,6090172,6590172,1590172,1.3180344,2006,grandmaâs boy2006
2258,unaccompanied minors,25000000,16655224,21970831,-3029169,0.87883324,2006,unaccompanied minors2006
4339,keeping up with the steins,5000000,4339241,4414753,-585247,0.8829506,2006,keeping up with the steins2006
3110,hoot,15000000,8117637,8224998,-6775002,0.5483332,2006,hoot2006
3884,akeelah and the bee,8000000,18848430,18959424,10959424,2.369928,2006,akeelah and the bee2006
1367,les bronzãs 3 amis pour la vie,42000000,0,83833602,41833602,1.9960381428571428,2006,les bronzãs 3 amis pour la vie2006
929,garfield a tail of two kitties,60000000,28426747,147985373,87985373,2.4664228833333333,2006,garfield a tail of two kitties2006
941,flyboys,60000000,13090630,14816379,-45183621,0.24693965,2006,flyboys2006
1395,scary movie 4,40000000,90710620,178710620,138710620,4.4677655,2006,scary movie 42006
316,night at the museum,110000000,250863268,579446407,469446407,5.267694609090909,2006,night at the museum2006
1995,miss potter,30000000,3005605,35891257,5891257,1.1963752333333333,2006,miss potter2006
1996,wu ji,30000000,669625,35869934,5869934,1.1956644666666667,2006,wu ji2006
4361,the oh in ohio,5000000,418689,648183,-4351817,0.1296366,2006,the oh in ohio2006
3090,idlewild,15000000,12669914,12669914,-2330086,0.8446609333333334,2006,idlewild2006
916,the sentinel,60000000,36280697,78080697,18080697,1.30134495,2006,the sentinel2006
3072,the marine,15000000,18844784,22165608,7165608,1.4777072,2006,the marine2006
3067,flicka,15000000,21000147,21896367,6896367,1.4597578,2006,flicka2006
1774,snakes on a plane,33000000,34020814,62020814,29020814,1.879418606060606,2006,snakes on a plane2006
2484,pulse,20500000,20264436,30241435,9741435,1.4751919512195122,2006,pulse2006
4583,unknown,3700000,26403,3355048,-344952,0.9067697297297297,2006,unknown2006
1632,the devil wears prada,35000000,124740460,326073155,291073155,9.316375857142857,2006,the devil wears prada2006
4406,hostel,4800000,47326473,82241110,77441110,17.13356458333333,2006,hostel2006
5584,the motel,250000,51540,51540,-198460,0.20616,2006,the motel2006
1403,eight below,40000000,81612565,120455994,80455994,3.01139985,2006,eight below2006
4409,tristram shandy a cock and bull story,4750000,1253413,3061763,-1688237,0.6445816842105263,2006,tristram shandy a cock and bull story2006
2069,just my luck,28000000,17326650,38159905,10159905,1.36285375,2006,just my luck2006
3353,step up,12000000,65328121,110989157,98989157,9.249096416666667,2006,step up2006
2764,borat,18000000,128505958,261443242,243443242,14.524624555555556,2006,borat2006
3303,find me guilty,13000000,1173673,2898225,-10101775,0.22294038461538462,2006,find me guilty2006
1912,stranger than fiction,30000000,40435190,53572822,23572822,1.7857607333333334,2006,stranger than fiction2006
3196,an american haunting,14000000,16298046,30443277,16443277,2.1745197857142857,2006,an american haunting2006
1105,inside man,50000000,88634237,185798265,135798265,3.7159653,2006,inside man2006
1136,firewall,50000000,48751189,82751189,32751189,1.65502378,2006,firewall2006
3894,bon cop bad cop,8000000,12671300,12740705,4740705,1.592588125,2006,bon cop bad cop2006
3136,banlieue 13,15000000,1200216,11599903,-3400097,0.7733268666666666,2006,banlieue 132006
881,the shaggy dog,60000000,61123569,87123569,27123569,1.4520594833333333,2006,the shaggy dog2006
4444,chinjeolhan geumjassi,4500000,211667,23471871,18971871,5.215971333333333,2006,chinjeolhan geumjassi2006
3817,opal dream,9000000,14443,14443,-8985557,0.0016047777777777777,2006,opal dream2006
1414,big mommas house 2,40000000,70165972,137047376,97047376,3.4261844,2006,big mommas house 22006
4469,nochnoy dozor,4200000,1502188,33913542,29713542,8.074652857142857,2006,nochnoy dozor2006
4473,high school musical,4200000,0,0,-4200000,0.0,2006,high school musical2006
823,perfume the story of a murderer,63700000,2223293,133603463,69903463,2.0973856043956043,2006,perfume the story of a murderer2006
3805,trust the man,9000000,1530535,2548378,-6451622,0.28315311111111113,2006,trust the man2006
821,little man,64000000,58636047,101636047,37636047,1.588063234375,2006,little man2006
4498,scoop,4000000,10525717,40103262,36103262,10.0258155,2006,scoop2006
1754,bandidas,35000000,0,19282590,-15717410,0.5509311428571428,2006,bandidas2006
4504,the night listener,4000000,7836393,10770993,6770993,2.69274825,2006,the night listener2006
1426,invincible,40000000,57806952,58501127,18501127,1.462528175,2006,invincible2006
1432,the prestige,40000000,53089891,104407366,64407366,2.61018415,2006,the prestige2006
3021,when a stranger calls,15000000,47860214,67215435,52215435,4.481029,2006,when a stranger calls2006
1275,underworld evolution,45000000,62318875,113417762,68417762,2.520394711111111,2006,underworld evolution2006
3784,black christmas,9000000,16235738,16235738,7235738,1.8039708888888888,2006,black christmas2006
3374,crank,12000000,27838408,43924923,31924923,3.66041025,2006,crank2006
3015,the queen,15000000,56441711,128885873,113885873,8.592391533333334,2006,the queen2006
1433,the lake house,40000000,52330111,114830111,74830111,2.870752775,2006,the lake house2006
801,we are marshall,65000000,43545364,43545364,-21454636,0.6699286769230769,2006,we are marshall2006
4412,driving lessons,4700000,239962,239962,-4460038,0.05105574468085106,2006,driving lessons2006
2720,the painted veil,19400000,8060487,15118795,-4281205,0.7793193298969072,2006,the painted veil2006
4971,say uncle,2000000,5361,5361,-1994639,0.0026805,2006,say uncle2006
5509,quinceanera,400000,1692693,2797199,2397199,6.9929975,2006,quinceanera2006
5738,mutual appreciation,30000,103509,103509,73509,3.4503,2006,mutual appreciation2006
5546,old joy,300000,255923,399908,99908,1.3330266666666666,2006,old joy2006
5225,transamerica,1000000,9015303,16553163,15553163,16.553163,2006,transamerica2006
233,miami vice,135000000,63478838,163818556,28818556,1.2134707851851851,2006,miami vice2006
5215,an inconvenient truth,1000000,24146161,53365925,52365925,53.365925,2006,an inconvenient truth2006
264,the da vinci code,125000000,217536138,767820459,642820459,6.142563672,2006,the da vinci code2006
2603,school for scoundrels,20000000,17807569,17807569,-2192431,0.89037845,2006,school for scoundrels2006
5494,brick,450000,2075743,4243996,3793996,9.431102222222222,2006,brick2006
4949,sherrybaby,2000000,199176,759504,-1240496,0.379752,2006,sherrybaby2006
5247,who killed the electric car,1000000,1678874,1849392,849392,1.849392,2006,who killed the electric car2006
2790,united 93,18000000,31567134,77635035,59635035,4.3130575,2006,united 932006
2541,the grudge 2,20000000,39143839,70743839,50743839,3.53719195,2006,the grudge 22006
5467,feng kuang de shi tou,500000,0,3000000,2500000,6.0,2006,feng kuang de shi tou2006
5766,clean,10000,138711,138711,128711,13.8711,2006,clean2006
5469,griffin  phoenix,500000,0,1355967,855967,2.711934,2006,griffin  phoenix2006
2450,joyeux noãl,22000000,1054361,23134075,1134075,1.0515488636363637,2006,joyeux noãl2006
2334,rocky balboa,24000000,70269899,156229050,132229050,6.50954375,2006,rocky balboa2006
5191,dead mans shoes,1125000,6408,414736,-710264,0.3686542222222222,2006,dead mans shoes2006
5763,grip a criminals story,12000,1336,1336,-10664,0.11133333333333334,2006,grip a criminals story2006
5775,cavite,7000,70071,71644,64644,10.234857142857143,2006,cavite2006
5630,the case of the grinning cat,200000,7033,7033,-192967,0.035165,2006,the case of the grinning cat2006
2546,man of the year,20000000,37442180,41342180,21342180,2.067109,2006,man of the year2006
144,poseidon,160000000,60674817,181674817,21674817,1.13546760625,2006,poseidon2006
5759,the puffy chair,15000,194523,195254,180254,13.016933333333334,2006,the puffy chair2006
4967,london,2000000,12667,12667,-1987333,0.0063335,2006,london2006
2628,one night with the king,20000000,13395961,13725032,-6274968,0.6862516,2006,one night with the king2006
5435,wordplay,500000,3121270,3177636,2677636,6.355272,2006,wordplay2006
5450,lonesome jim,500000,154187,602789,102789,1.205578,2006,lonesome jim2006
4133,the last king of scotland,6000000,17606684,49155371,43155371,8.192561833333333,2006,the last king of scotland2006
2308,bloodrayne,25000000,2405420,3711633,-21288367,0.14846532,2006,bloodrayne2006
5142,simon,1300000,4055,1738663,438663,1.337433076923077,2006,simon2006
5297,in her line of fire,1000000,884,884,-999116,0.000884,2006,in her line of fire2006
2756,indigãnes,18900000,320700,26063572,7163572,1.3790249735449736,2006,indigãnes2006
2526,date movie,20000000,48548426,85146165,65146165,4.25730825,2006,date movie2006
23,superman returns,232000000,200120000,374085065,142085065,1.612435625,2006,superman returns2006
2582,the covenant,20000000,23364784,38164784,18164784,1.9082392,2006,the covenant2006
37,xmen the last stand,210000000,234362462,459260946,249260946,2.186956885714286,2006,xmen the last stand2006
5504,moartea domnului lazarescu,425000,80301,581304,156304,1.3677741176470588,2006,moartea domnului lazarescu2006
5373,iraq for sale the war profiteers,775000,0,0,-775000,0.0,2006,iraq for sale the war profiteers2006
5276,once in a lifetime the extraordinary story of the new york cosmos,1000000,144601,215559,-784441,0.215559,2006,once in a lifetime the extraordinary story of the new york cosmos2006
2686,the proposition,20000000,1903434,5313608,-14686392,0.2656804,2006,the proposition2006
2584,stay alive,20000000,23086480,23187506,3187506,1.1593753,2006,stay alive2006
179,mission impossible iii,150000000,133501348,397501348,247501348,2.6500089866666667,2006,mission impossible iii2006
5390,half nelson,700000,2697938,4911725,4211725,7.01675,2006,half nelson2006
5110,fetching cody,1500000,0,0,-1500000,0.0,2006,fetching cody2006
2555,babel,20000000,34302837,132121212,112121212,6.6060606,2006,babel2006
388,blood diamond,100000000,57377916,171377916,71377916,1.71377916,2006,blood diamond2006
27,pirates of the caribbean dead manâs chest,225000000,423315812,1066215812,841215812,4.738736942222222,2006,pirates of the caribbean dead manâs chest2006
5327,hard candy,950000,1024640,8267066,7317066,8.702174736842105,2006,hard candy2006
5551,sisters in law,300000,33312,33312,-266688,0.11104,2006,sisters in law2006
5056,bubble,1600000,145382,145382,-1454618,0.09086375,2006,bubble2006
5680,facing the giants,100000,10178331,10243159,10143159,102.43159,2006,facing the giants2006
5304,jimmy and judy,1000000,0,0,-1000000,0.0,2006,jimmy and judy2006
5531,51 birch street,350000,84689,84689,-265311,0.24196857142857142,2006,51 birch street2006
2669,a scanner darkly,20000000,5501616,7405084,-12594916,0.3702542,2006,a scanner darkly2006
5496,conversations with other women,450000,379418,1297745,847745,2.8838777777777778,2006,conversations with other women2006
5673,the blood of my brother a story of death in iraq,120000,0,0,-120000,0.0,2006,the blood of my brother a story of death in iraq2006
2571,stick it,20000000,26910736,30399714,10399714,1.5199857,2006,stick it2006
382,eragon,100000000,75030163,249488115,149488115,2.49488115,2006,eragon2006
5341,the quiet,900000,381420,381420,-518580,0.4238,2006,the quiet2006
2659,doogal,20000000,7578946,28058652,8058652,1.4029326,2006,doogal2006
195,flushed away,149000000,64665672,179357126,30357126,1.2037391006711409,2006,flushed away2006
5301,loving annabelle,1000000,0,5382,-994618,0.005382,2006,loving annabelle2006
1117,v for vendetta,50000000,70511035,130214162,80214162,2.60428324,2006,v for vendetta2006
3760,volver,9400000,12899867,87226613,77826613,9.279426914893618,2006,volver2006
3948,imagine me  you,7900000,672243,3129471,-4770529,0.39613556962025315,2006,imagine me  you2006
2937,el laberinto del fauno,16000000,37634615,87041569,71041569,5.4400980625,2006,el laberinto del fauno2006
3414,for your consideration,12000000,5549923,5549923,-6450077,0.46249358333333335,2006,for your consideration2006
1725,zoom,35000000,11989328,12506188,-22493812,0.35731965714285713,2006,zoom2006
4000,the descent,7000000,26024456,57051053,50051053,8.150150428571429,2006,the descent2006
3440,fateless,12000000,196857,196857,-11803143,0.01640475,2006,fateless2006
2859,hoodwinked,17500000,51386611,109843390,92343390,6.276765142857143,2006,hoodwinked2006
3589,employee of the month,10000000,28444855,38364855,28364855,3.8364855,2006,employee of the month2006
529,charlottes web,82500000,82985708,143985708,61485708,1.7452813090909092,2006,charlottes web2006
528,click,82500000,137355633,237685089,155185089,2.8810313818181816,2006,click2006
2847,renaissance,18000000,70644,2401413,-15598587,0.13341183333333334,2006,renaissance2006
3547,madeas family reunion,10000000,63257940,63320521,53320521,6.3320521,2006,madeas family reunion2006
3540,saw iii,10000000,80238724,163876815,153876815,16.3876815,2006,saw iii2006
2223,shes the man,25000000,33889159,55279608,30279608,2.21118432,2006,shes the man2006
647,monster house,75000000,73661010,141267370,66267370,1.8835649333333333,2006,monster house2006
4832,marilyn hotchkiss ballroom dancing and charm school,2500000,349132,497195,-2002805,0.198878,2006,marilyn hotchkiss ballroom dancing and charm school2006
507,the holiday,85000000,63280000,205190324,120190324,2.414003811764706,2006,the holiday2006
4854,idiocracy,2400000,444093,500296,-1899704,0.20845666666666668,2006,idiocracy2006
503,open season,85000000,85105259,191932158,106932158,2.258025388235294,2006,open season2006
1651,the benchwarmers,35000000,59843754,65063726,30063726,1.8589636,2006,the benchwarmers2006
488,happy feet,85000000,198000317,385000317,300000317,4.529415494117647,2006,happy feet2006
3519,kabhi alvida naa kehna,10750000,3275443,32575443,21825443,3.0302737674418605,2006,kabhi alvida naa kehna2006
3509,copying beethoven,11000000,355968,6586324,-4413676,0.5987567272727272,2006,copying beethoven2006
446,the departed,90000000,132384315,289660619,199660619,3.218451322222222,2006,the departed2006
4920,harsh times,2000000,3337931,6225304,4225304,3.112652,2006,harsh times2006
4927,strangers with candy,2000000,2072645,2077844,77844,1.038922,2006,strangers with candy2006
4930,shortbus,2000000,1985292,1985292,-14708,0.992646,2006,shortbus2006
2861,beerfest,17500000,19185184,20159316,2659316,1.1519609142857143,2006,beerfest2006
591,the wild,80000000,37384046,99010667,19010667,1.2376333375,2006,the wild2006
508,the fast and the furious tokyo drift,85000000,62615510,157794205,72794205,1.8564024117647058,2006,the fast and the furious tokyo drift2006
3411,running with scissors,12000000,6860000,8706701,-3293299,0.7255584166666667,2006,running with scissors2006
3716,edmond,10000000,131719,241719,-9758281,0.0241719,2006,edmond2006
1737,a good year,35000000,7459300,42064105,7064105,1.2018315714285714,2006,a good year2006
4689,dave chappelles block party,3000000,11718595,12051924,9051924,4.017308,2006,dave chappelles block party2006
2990,slither,15250000,7802450,12930343,-2319657,0.8478913442622951,2006,slither2006
2087,notes on a scandal,27500000,17510118,50578411,23078411,1.8392149454545454,2006,notes on a scandal2006
747,basic instinct 2,70000000,5946136,35417162,-34582838,0.5059594571428572,2006,basic instinct 22006
631,ice age the meltdown,75000000,195330621,651899282,576899282,8.691990426666667,2006,ice age the meltdown2006
3688,krrish,10000000,1430721,32430721,22430721,3.2430721,2006,krrish2006
4626,the secret,3500000,0,0,-3500000,0.0,2006,the secret2006
641,dreamgirls,75000000,103365956,155708695,80708695,2.0761159333333334,2006,dreamgirls2006
1906,glory road,30000000,42647449,42799060,12799060,1.4266353333333333,2006,glory road2006
4703,phat girlz,3000000,7061128,7301115,4301115,2.433705,2006,phat girlz2006
2917,fur an imaginary portrait of diane arbus,16800000,223202,2281089,-14518911,0.13577910714285715,2006,fur an imaginary portrait of diane arbus2006
4707,water,3000000,5529144,11322573,8322573,3.774191,2006,water2006
3676,peaceful warrior,10000000,2893666,3260179,-6739821,0.3260179,2006,peaceful warrior2006
4723,tsotsi,3000000,2912606,11537539,8537539,3.8458463333333333,2006,tsotsi2006
623,children of men,76000000,35552383,69845011,-6154989,0.919013302631579,2006,children of men2006
2921,the illusionist,16500000,39868642,83792062,67292062,5.0783067878787875,2006,the illusionist2006
2936,the texas chainsaw massacre the beginning,16000000,39517763,50517763,34517763,3.1573601875,2006,the texas chainsaw massacre the beginning2006
2101,lucky number slevin,27000000,22495466,55495466,28495466,2.05538762962963,2006,lucky number slevin2006
4619,winter passing,3500000,107492,113783,-3386217,0.03250942857142857,2006,winter passing2006
4646,the dead girl,3300000,19875,19875,-3280125,0.0060227272727272725,2006,the dead girl2006
1733,the fountain,35000000,10144010,15461638,-19538362,0.44176108571428574,2006,the fountain2006
2117,the magic flute,27000000,0,0,-27000000,0.0,2006,the magic flute2006
693,cars,70000000,244082982,461651246,391651246,6.5950178,2006,cars2006
3389,aquamarine,12000000,18597342,22978953,10978953,1.91491275,2006,aquamarine2006
3751,the lost city,9600000,2484186,5256839,-4343161,0.5475873958333334,2006,the lost city2006
4659,feast,3200000,56131,690872,-2509128,0.2158975,2006,feast2006
675,talladega nights the ballad of ricky bobby,73000000,148213377,162870525,89870525,2.231103082191781,2006,talladega nights the ballad of ricky bobby2006
721,the guardian,70000000,55011732,94973540,24973540,1.3567648571428572,2006,the guardian2006
656,lady in the water,75000000,42285169,72785169,-2214831,0.97046892,2006,lady in the water2006
3470,jackass number two,11000000,72778712,85278712,74278712,7.752610181818182,2006,jackass number two2006
544,over the hedge,80000000,155019340,343397247,263397247,4.2924655875,2006,over the hedge2006
1437,apocalypto,40000000,50866635,121032272,81032272,3.0258068,2006,apocalypto2006
2902,running scared,17000000,6855137,9729088,-7270912,0.572299294117647,2006,running scared2006
3931,10th  wolf,8000000,54702,143782,-7856218,0.01797275,2006,10th  wolf2006
1945,my super exgirlfriend,30000000,22530295,60772856,30772856,2.0257618666666666,2006,my super exgirlfriend2006
1050,you me and dupree,54000000,75802010,130402010,76402010,2.414852037037037,2006,you me and dupree2006
1042,all the kings men,55000000,7221458,9521458,-45478542,0.1731174181818182,2006,all the kings men2006
3919,down in the valley,8000000,568932,973443,-7026557,0.121680375,2006,down in the valley2006
4236,rang de basanti,5300000,2197694,29197694,23897694,5.508998867924528,2006,rang de basanti2006
1005,rv,55000000,71724497,87473024,32473024,1.5904186181818183,2006,rv2006
1792,nacho libre,32000000,80197993,99296462,67296462,3.1030144375,2006,nacho libre2006
4279,clerks ii,5000000,24148068,27342246,22342246,5.4684492,2006,clerks ii2006
1955,ultraviolet,30000000,18522064,30962112,962112,1.0320704,2006,ultraviolet2006
1926,take the lead,30000000,34742066,65390493,35390493,2.1796831,2006,take the lead2006
4156,la science des rãªves,6000000,4670644,15137932,9137932,2.5229886666666665,2006,la science des rãªves2006
1104,failure to launch,50000000,88715192,128402901,78402901,2.56805802,2006,failure to launch2006
4208,crossover,5600000,7009668,7009668,1409668,1.2517264285714285,2006,crossover2006
1917,gridiron gang,30000000,38432823,41457834,11457834,1.3819278,2006,gridiron gang2006
1291,last holiday,45000000,38399961,43343247,-1656753,0.9631832666666666,2006,last holiday2006
1292,16 blocks,45000000,36895141,65595141,20595141,1.4576698,2006,16 blocks2006
1295,the ant bully,45000000,28142535,49610898,4610898,1.1024644,2006,the ant bully2006
3281,letters from iwo jima,13000000,13756082,67867998,54867998,5.220615230769231,2006,letters from iwo jima2006
1817,the good german,32000000,1308696,6678033,-25321967,0.20868853125,2006,the good german2006
4091,friends with money,6500000,13368437,18110152,11610152,2.7861772307692307,2006,friends with money2006
3216,catch a fire,14000000,4299773,5782198,-8217802,0.41301414285714283,2006,catch a fire2006
3956,thank you for smoking,7500000,24793509,40016662,32516662,5.335554933333333,2006,thank you for smoking2006
986,the pursuit of happyness,55000000,162586036,307311093,252311093,5.587474418181818,2006,the pursuit of happyness2006
3212,little children,14000000,5463019,14121177,121177,1.0086555,2006,little children2006
3207,bobby,14000000,11242801,20597806,6597806,1.4712718571428571,2006,bobby2006
1124,curious george,50000000,58640119,71052604,21052604,1.42105208,2006,curious george2006
4740,loves abiding joy,3000000,252726,252726,-2747274,0.084242,2006,loves abiding joy2006
4056,wahwah,7000000,234750,463039,-6536961,0.06614842857142857,2006,wahwah2006
1062,flags of our fathers,53000000,33602376,63657941,10657941,1.2010932264150944,2006,flags of our fathers2006
1141,silent hill,50000000,46982632,94704227,44704227,1.89408454,2006,silent hill2006
4203,tom yum goong,5700000,12044087,43044087,37344087,7.551594210526316,2006,tom yum goong2006
2900,american dreamz,17000000,7314027,16510971,-489029,0.9712335882352942,2006,american dreamz2006
1321,man cheng jin dai huang jin jia,45000000,6566773,76904429,31904429,1.7089873111111111,2006,man cheng jin dai huang jin jia2006
1501,marie antoinette,40000000,15962471,60862471,20862471,1.521561775,2006,marie antoinette2006
4582,the history boys,3700000,2730296,13447998,9747998,3.634594054054054,2006,the history boys2006
2894,larry the cable guy health inspector,17000000,15680099,15680099,-1319901,0.9223587647058824,2006,larry the cable guy health inspector2006
3648,turistas,10000000,7027762,14321070,4321070,1.432107,2006,turistas2006
2891,atl,17000000,21170563,21170563,4170563,1.2453272352941176,2006,atl2006
579,dãjã vu,80000000,64038616,181038616,101038616,2.2629827,2006,dãjã vu2006
2190,final destination 3,25000000,54098051,112798051,87798051,4.51192204,2006,final destination 32006
569,the pink panther,80000000,82226474,158926474,78926474,1.986580925,2006,the pink panther2006
2881,the hills have eyes,17000000,41778863,70355813,53355813,4.138577235294117,2006,the hills have eyes2006
4778,boynton beach club,2900000,3127472,3127472,227472,1.0784386206896552,2006,boynton beach club2006
1533,alex rider operation stormbreaker,40000000,659210,20722450,-19277550,0.51806125,2006,alex rider operation stormbreaker2006
4787,artie langes beer league,2800000,475000,475000,-2325000,0.16964285714285715,2006,artie langes beer league2006
4747,sommersturm,3000000,95204,95204,-2904796,0.03173466666666667,2006,sommersturm2006
2199,nanny mcphee,25000000,47279279,128745578,103745578,5.14982312,2006,nanny mcphee2006
3628,end of the spear,10000000,11748661,11924041,1924041,1.1924041,2006,end of the spear2006
3305,infamous,13000000,1151330,2613717,-10386283,0.20105515384615386,2006,infamous2006
4180,come early morning,6000000,119452,119452,-5880548,0.019908666666666668,2006,come early morning2006
3170,manderlay,14200000,74205,543306,-13656694,0.03826098591549296,2006,manderlay2006
1079,deck the halls,51000000,35093569,46815807,-4184193,0.917957,2006,deck the halls2006
4161,venus,6000000,3347411,7818479,1818479,1.3030798333333333,2006,venus2006
1077,barnyard the original party animals,51000000,72779000,118583844,67583844,2.325173411764706,2006,barnyard the original party animals2006
4510,lets go to prison,4000000,4630045,4630045,630045,1.15751125,2006,lets go to prison2006
4793,lage raho munna bhai,2700000,2217561,31517561,28817561,11.67317074074074,2006,lage raho munna bhai2006
792,world trade center,65000000,70278893,163295654,98295654,2.5122408307692305,2006,world trade center2006
1672,the nativity story,35000000,37629831,46309644,11309644,1.3231326857142858,2006,the nativity story2006
1068,the breakup,52000000,118703275,205727307,153727307,3.956294365384615,2006,the breakup2006
3603,a prairie home companion,10000000,20342852,26716191,16716191,2.6716191,2006,a prairie home companion2006
4577,casa de areia,3750000,539285,1178175,-2571825,0.31418,2006,casa de areia2006
499,i now pronounce you chuck and larry,85000000,119725280,185708462,100708462,2.1848054352941175,2007,i now pronounce you chuck and larry2007
3604,reno 911 miami,10000000,20342161,21851362,11851362,2.1851362,2007,reno 911 miami2007
3715,severance,10000000,137221,5950002,-4049998,0.5950002,2007,severance2007
2910,southland tales,17000000,275380,364607,-16635393,0.021447470588235294,2007,southland tales2007
5065,waitress,1500000,19097550,22217183,20717183,14.811455333333333,2007,waitress2007
2467,freedom writers,21000000,36605602,43632609,22632609,2.077743285714286,2007,freedom writers2007
2539,epic movie,20000000,39739367,86858578,66858578,4.3429289,2007,epic movie2007
3695,the brothers solomon,10000000,900926,900926,-9099074,0.0900926,2007,the brothers solomon2007
5029,sublime,1800000,0,0,-1800000,0.0,2007,sublime2007
2221,good luck chuck,25000000,35017297,59183821,34183821,2.36735284,2007,good luck chuck2007
4857,this is england,2380000,327919,8739576,6359576,3.672090756302521,2007,this is england2007
2225,mr beanâs holiday,25000000,33302167,234981342,209981342,9.39925368,2007,mr beanâs holiday2007
371,american gangster,100000000,130164645,267985456,167985456,2.67985456,2007,american gangster2007
387,surfs up,100000000,58867694,145395745,45395745,1.45395745,2007,surfs up2007
1487,the reaping,40000000,25126214,62226214,22226214,1.55565535,2007,the reaping2007
3743,partition,10000000,0,0,-10000000,0.0,2007,partition2007
4839,eye of the dolphin,2500000,72210,72260,-2427740,0.028904,2007,eye of the dolphin2007
2180,no country for old men,25000000,74273505,164035753,139035753,6.56143012,2007,no country for old men2007
1666,license to wed,35000000,43799818,70187088,35187088,2.0053453714285716,2007,license to wed2007
15,spiderman 3,258000000,336530303,894860230,636860230,3.468450503875969,2007,spiderman 32007
3704,king of california,10000000,268461,1165102,-8834898,0.1165102,2007,king of california2007
500,oceans thirteen,85000000,117144465,311744465,226744465,3.6675819411764707,2007,oceans thirteen2007
4853,thr3e,2400000,1008849,1420418,-979582,0.5918408333333334,2007,thr3e2007
3424,gwoemul,12000000,2201923,92618117,80618117,7.718176416666667,2007,gwoemul2007
3659,rescue dawn,10000000,5490423,7037886,-2962114,0.7037886,2007,rescue dawn2007
606,the invasion,80000000,15074191,40147042,-39852958,0.501838025,2007,the invasion2007
320,live free or die hard,110000000,134529403,382288147,272288147,3.4753467909090907,2007,live free or die hard2007
2229,august rush,25000000,31664162,65882103,40882103,2.63528412,2007,august rush2007
5363,cama adentro,800000,200433,200433,-599567,0.25054125,2007,cama adentro2007
2365,flood,24000000,0,4084232,-19915768,0.17017633333333335,2007,flood2007
2578,nancy drew,20000000,25584685,30703845,10703845,1.53519225,2007,nancy drew2007
3103,a mighty heart,15000000,9176787,19153568,4153568,1.2769045333333333,2007,a mighty heart2007
3101,black snake moan,15000000,9396870,10951153,-4048847,0.7300768666666667,2007,black snake moan2007
2652,death at a funeral,20000000,8580428,46790428,26790428,2.3395214,2007,death at a funeral2007
2984,la mãme,15500000,10299782,88611837,73111837,5.71689270967742,2007,la mãme2007
1915,30 days of night,30000000,39568996,80276156,50276156,2.6758718666666668,2007,30 days of night2007
5094,hatchet,1500000,175281,240396,-1259604,0.160264,2007,hatchet2007
40,the golden compass,205000000,70107728,367262558,162262558,1.7915246731707317,2007,the golden compass2007
1721,lions for lambs,35000000,14998070,63211088,28211088,1.8060310857142856,2007,lions for lambs2007
605,arthur et les minimoys,80000000,15132763,113325743,33325743,1.4165717875,2007,arthur et les minimoys2007
5092,i want someone to eat cheese with,1500000,194568,194568,-1305432,0.129712,2007,i want someone to eat cheese with2007
1714,walk hard the dewey cox story,35000000,18317151,20606053,-14393947,0.5887443714285714,2007,walk hard the dewey cox story2007
2295,the hoax,25000000,7164995,7164995,-17835005,0.2865998,2007,the hoax2007
520,zodiac,85000000,33080084,83080084,-1919916,0.9774127529411765,2007,zodiac2007
2922,becoming jane,16500000,18663911,39380876,22880876,2.3867197575757575,2007,becoming jane2007
3729,blonde ambition,10000000,6422,1537479,-8462521,0.1537479,2007,blonde ambition2007
1546,because i said so,39000000,42674040,69538833,30538833,1.783047,2007,because i said so2007
2924,sydney white,16500000,11892415,13636339,-2863661,0.8264447878787878,2007,sydney white2007
3439,trade,12000000,214202,1513388,-10486612,0.12611566666666665,2007,trade2007
2925,arn  tempelriddaren,16500000,0,21404122,4904122,1.2972195151515151,2007,arn  tempelriddaren2007
5098,the salon,1500000,139084,139084,-1360916,0.09272266666666666,2007,the salon2007
5674,a dogs breakfast,120000,0,0,-120000,0.0,2007,a dogs breakfast2007
1550,shoot em up,39000000,12796824,26796824,-12203176,0.6870980512820513,2007,shoot em up2007
3534,september dawn,10100000,1066555,1066555,-9033445,0.10559950495049505,2007,september dawn2007
2173,bridge to terabithia,25000000,82234139,137984788,112984788,5.51939152,2007,bridge to terabithia2007
2529,premonition,20000000,47852604,81461343,61461343,4.07306715,2007,premonition2007
497,enchanted,85000000,127706877,340384141,255384141,4.0045193058823525,2007,enchanted2007
1451,aliens vs predator  requiem,40000000,41797066,128884494,88884494,3.22211235,2007,aliens vs predator  requiem2007
5135,journey from the fall,1300000,635305,635305,-664695,0.48869615384615384,2007,journey from the fall2007
4872,the last sin eater,2200000,388390,388390,-1811610,0.17654090909090908,2007,the last sin eater2007
2939,the messengers,16000000,35374833,53774833,37774833,3.3609270625,2007,the messengers2007
2209,there will be blood,25000000,40222514,77208711,52208711,3.08834844,2007,there will be blood2007
649,charlie wilsons war,75000000,66661095,119512771,44512771,1.5935036133333333,2007,charlie wilsons war2007
1536,nomad,40000000,79123,79123,-39920877,0.001978075,2007,nomad2007
5634,the man from earth,200000,0,0,-200000,0.0,2007,the man from earth2007
682,the kingdom,72500000,47467250,86509602,14009602,1.1932358896551725,2007,the kingdom2007
1438,music and lyrics,40000000,50572589,146196885,106196885,3.654922125,2007,music and lyrics2007
288,ghost rider,120000000,115802596,229545589,109545589,1.9128799083333334,2007,ghost rider2007
2945,hot fuzz,16000000,23618786,81742618,65742618,5.108913625,2007,hot fuzz2007
1532,the hunting party,40000000,876671,7729552,-32270448,0.1932388,2007,the hunting party2007
2712,butterfly on a wheel,20000000,0,0,-20000000,0.0,2007,butterfly on a wheel2007
5633,the trials of darryl hunt,200000,1217,1217,-198783,0.006085,2007,the trials of darryl hunt2007
2864,taxi 4,17500000,0,60865364,43365364,3.4780208,2007,taxi 42007
1656,tmnt,35000000,54149098,96096018,61096018,2.7456005142857145,2007,tmnt2007
4983,rockaway,2000000,0,0,-2000000,0.0,2007,rockaway2007
3546,saw iv,10000000,63300095,135759694,125759694,13.5759694,2007,saw iv2007
2245,war,25000000,22486409,40686409,15686409,1.62745636,2007,war2007
679,the simpsons movie,72500000,183135014,527071022,454571022,7.269945131034483,2007,the simpsons movie2007
108,evan almighty,175000000,100289690,174131329,-868671,0.9950361657142858,2007,evan almighty2007
286,fantastic four rise of the silver surfer,120000000,131921738,289480691,169480691,2.4123390916666665,2007,fantastic four rise of the silver surfer2007
2741,gone baby gone,19000000,20300218,34352162,15352162,1.8080085263157895,2007,gone baby gone2007
7,pirates of the caribbean at worldâs end,300000000,309420425,963420425,663420425,3.2114014166666665,2007,pirates of the caribbean at worldâs end2007
1527,sunshine,40000000,3688560,32030610,-7969390,0.80076525,2007,sunshine2007
4744,holly,3000000,163069,163069,-2836931,0.05435633333333333,2007,holly2007
5656,once,150000,9445857,23323631,23173631,155.49087333333333,2007,once2007
2884,smokin aces,17000000,35662731,57263440,40263440,3.3684376470588235,2007,smokin aces2007
1452,the water horse legend of the deep,40000000,40412817,103429755,63429755,2.585743875,2007,the water horse legend of the deep2007
639,hairspray,75000000,118871849,203035572,128035572,2.70714096,2007,hairspray2007
4898,das leben der anderen,2000000,11284657,81197047,79197047,40.5985235,2007,das leben der anderen2007
2272,hot rod,25000000,13938332,14334401,-10665599,0.57337604,2007,hot rod2007
2454,michael clayton,21500000,49033882,92987651,71487651,4.3250070232558135,2007,michael clayton2007
2453,moliãre,21600000,635733,791154,-20808846,0.0366275,2007,moliãre2007
2111,martian child,27000000,7500310,9352089,-17647911,0.3463736666666667,2007,martian child2007
3792,the savages,9000000,6623082,10642023,1642023,1.182447,2007,the savages2007
4617,ira and abby,3500000,221096,221096,-3278904,0.06317028571428572,2007,ira and abby2007
5764,tin can man,12000,0,0,-12000,0.0,2007,tin can man2007
4643,bella,3300000,8093373,12405473,9105473,3.7592342424242426,2007,bella2007
3778,sicko,9000000,24538513,36535837,27535837,4.0595374444444445,2007,sicko2007
3527,in the land of women,10500000,11052958,14140402,3640402,1.3467049523809524,2007,in the land of women2007
2856,superbad,17500000,121463226,169955142,152455142,9.7117224,2007,superbad2007
3518,jindabyne,10800000,399879,2862544,-7937456,0.2650503703703704,2007,jindabyne2007
3799,the ultimate gift,9000000,3438735,3438735,-5561265,0.38208166666666665,2007,the ultimate gift2007
4807,timber falls,2600000,0,71248,-2528752,0.027403076923076922,2007,timber falls2007
5011,chacun sa nuit,1900000,18435,139317,-1760683,0.07332473684210526,2007,chacun sa nuit2007
3801,gracie,9000000,2956339,3922043,-5077957,0.43578255555555556,2007,gracie2007
2506,disturbia,20000000,80818974,118537627,98537627,5.92688135,2007,disturbia2007
4938,in the shadow of the moon,2000000,1134358,2175587,175587,1.0877935,2007,in the shadow of the moon2007
2968,things we lost in the fire,16000000,3287315,8120148,-7879852,0.50750925,2007,things we lost in the fire2007
187,beowulf,150000000,82280579,195080579,45080579,1.3005371933333334,2007,beowulf2007
1322,love in the time of cholera,45000000,4617608,31077418,-13922582,0.6906092888888888,2007,love in the time of cholera2007
2645,death sentence,20000000,9534258,16907831,-3092169,0.84539155,2007,death sentence2007
3852,namastey london,8400000,1207007,6831069,-1568931,0.8132225,2007,namastey london2007
5290,alone with her,1000000,10787,844377,-155623,0.844377,2007,alone with her2007
2447,zwartboek,22000000,4398532,27238354,5238354,1.238107,2007,zwartboek2007
2676,iâm not there,20000000,4017609,12397613,-7602387,0.61988065,2007,iâm not there2007
836,blades of glory,61000000,118594548,145594548,84594548,2.386795868852459,2007,blades of glory2007
2080,alatriste,28000000,0,22860477,-5139523,0.8164456071428572,2007,alatriste2007
844,300,60000000,210614939,454161935,394161935,7.569365583333333,2007,3002007
845,wild hogs,60000000,168213584,253555383,193555383,4.22592305,2007,wild hogs2007
2081,knocked up,27500000,148761765,219265952,191765952,7.973307345454545,2007,knocked up2007
3920,brooklyn rules,8000000,458232,458232,-7541768,0.057279,2007,brooklyn rules2007
3841,the namesake,8500000,13610521,20288774,11788774,2.3869145882352942,2007,the namesake2007
4450,fong juk,4500000,51957,51957,-4448043,0.011546,2007,fong juk2007
3926,the wendell baker story,8000000,127188,127188,-7872812,0.0158985,2007,the wendell baker story2007
4507,bug,4000000,7006708,8302995,4302995,2.07574875,2007,bug2007
3977,ta ra rum pum,7400000,872643,9443864,2043864,1.2761978378378378,2007,ta ra rum pum2007
5326,and then came love,989000,8158,8158,-980842,0.008248736097067746,2007,and then came love2007
164,ratatouille,150000000,206445654,626549695,476549695,4.176997966666667,2007,ratatouille2007
1896,atonement,30000000,50980159,129779728,99779728,4.325990933333333,2007,atonement2007
2393,in the valley of elah,23000000,6777741,24489150,1489150,1.0647456521739131,2007,in the valley of elah2007
1045,lucky you,55000000,5755286,6521829,-48478171,0.11857870909090909,2007,lucky you2007
4106,control,6400000,871577,8902141,2502141,1.39095953125,2007,control2007
1037,elizabeth the golden age,55000000,16285240,74870866,19870866,1.3612884727272727,2007,elizabeth the golden age2007
5412,arnolds park,600000,23616,23616,-576384,0.03936,2007,arnolds park2007
3855,the wind that shakes the barley,8300000,1829142,25670174,17370174,3.092792048192771,2007,the wind that shakes the barley2007
3328,lars and the real girl,12500000,5956480,11277119,-1222881,0.90216952,2007,lars and the real girl2007
4506,el orfanato,4000000,7159147,79250193,75250193,19.81254825,2007,el orfanato2007
766,the last legion,67000000,5932060,25357771,-41642229,0.3784741940298507,2007,the last legion2007
86,rush hour 3,180000000,140125968,256585882,76585882,1.4254771222222222,2007,rush hour 32007
3053,28 weeks later,15000000,28638916,64232714,49232714,4.282180933333334,2007,28 weeks later2007
3048,the great debaters,15000000,30226144,30261293,15261293,2.0174195333333333,2007,the great debaters2007
1261,the bucket list,45000000,93466502,174807445,129807445,3.884609888888889,2007,the bucket list2007
2065,we own the night,28000000,28563179,55307857,27307857,1.9752806071428572,2007,we own the night2007
3939,the death and life of bobby z,8000000,0,414617,-7585383,0.051827125,2007,the death and life of bobby z2007
742,next,70000000,18211013,73591500,3591500,1.0513071428571428,2007,next2007
239,the bourne ultimatum,130000000,227471070,444043396,314043396,3.415718430769231,2007,the bourne ultimatum2007
901,shooter,60000000,47003582,95538560,35538560,1.5923093333333334,2007,shooter2007
3828,awake,8600000,14373825,32968648,24368648,3.8335637209302327,2007,awake2007
2986,slow burn,15500000,1237615,1237615,-14262385,0.07984612903225806,2007,slow burn2007
1165,hannibal rising,50000000,27669725,80583311,30583311,1.61166622,2007,hannibal rising2007
4422,out of the blue,4600000,728,731767,-3868233,0.15907978260869565,2007,out of the blue2007
1802,the number 23,32000000,35193167,77593167,45593167,2.42478646875,2007,the number 232007
2009,goodbye bafana,30000000,0,2717302,-27282698,0.09057673333333334,2007,goodbye bafana2007
2088,rendition,27500000,9736045,26939925,-560075,0.9796336363636363,2007,rendition2007
731,the brave one,70000000,36793804,69792704,-207296,0.9970386285714286,2007,the brave one2007
3508,romance and cigarettes,11000000,551002,3231251,-7768749,0.29375009090909093,2007,romance and cigarettes2007
3922,fido,8000000,298110,456814,-7543186,0.05710175,2007,fido2007
3016,why did i get married,15000000,55204525,55934178,40934178,3.7289452,2007,why did i get married2007
5267,wristcutters a love story,1000000,446165,473769,-526231,0.473769,2007,wristcutters a love story2007
4518,you kill me,4000000,2426851,3858964,-141036,0.964741,2007,you kill me2007
2343,hitman,24000000,39687694,99135571,75135571,4.130648791666666,2007,hitman2007
2056,no reservations,28000000,43107979,91943956,63943956,3.283712714285714,2007,no reservations2007
3942,maurice richard,8000000,0,0,-8000000,0.0,2007,maurice richard2007
4935,no end in sight,2000000,1433319,1433319,-566681,0.7166595,2007,no end in sight2007
5586,shotgun stories,250000,46026,284174,34174,1.136696,2007,shotgun stories2007
1885,ps i love you,30000000,53695808,155769678,125769678,5.1923226,2007,ps i love you2007
3979,persepolis,7300000,4443403,25397187,18097187,3.479066712328767,2007,persepolis2007
4366,gandhi my father,5000000,240425,2015004,-2984996,0.4030008,2007,gandhi my father2007
727,stardust,70000000,38634938,137022245,67022245,1.9574606428571428,2007,stardust2007
2000,doa dead or alive,30000000,480314,7755686,-22244314,0.2585228666666667,2007,doa dead or alive2007
1299,across the universe,45000000,24343673,29367143,-15632857,0.6526031777777778,2007,across the universe2007
3283,the astronaut farmer,13000000,11003643,11141213,-1858787,0.8570163846153847,2007,the astronaut farmer2007
4376,redacted,5000000,65388,861325,-4138675,0.172265,2007,redacted2007
1813,dragon wars dwar,32000000,10977721,79915361,47915361,2.49735503125,2007,dragon wars dwar2007
3293,paris je taime,13000000,4857374,5175088,-7824912,0.3980836923076923,2007,paris je taime2007
4387,farce of the penguins,5000000,0,0,-5000000,0.0,2007,farce of the penguins2007
3957,hostel part ii,7500000,17544812,33606409,26106409,4.480854533333333,2007,hostel part ii2007
3068,the hills have eyes ii,15000000,20804166,37466538,22466538,2.4977692,2007,the hills have eyes ii2007
1991,the assassination of jesse james by the coward robert ford,30000000,3909149,15313631,-14686369,0.5104543666666667,2007,the assassination of jesse james by the coward robert ford2007
5548,pierrot le fou,300000,70807,71380,-228620,0.23793333333333333,2007,pierrot le fou2007
2654,code name the cleaner,20000000,8135024,8135024,-11864976,0.4067512,2007,code name the cleaner2007
3270,the mist,13000000,25593755,57189408,44189408,4.3991852307692305,2007,the mist2007
4030,whos your caddy,7000000,5694308,5694308,-1305692,0.8134725714285714,2007,whos your caddy2007
3121,se jie,15000000,4604982,65167430,50167430,4.344495333333334,2007,se jie2007
1224,310 to yuma,48000000,53606916,71171825,23171825,1.4827463541666666,2007,310 to yuma2007
1972,evening,30000000,12406646,12885574,-17114426,0.42951913333333336,2007,evening2007
3256,this christmas,13000000,49121934,49733545,36733545,3.8256573076923077,2007,this christmas2007
1237,happily never after,47000000,15849032,37923818,-9076182,0.8068897446808511,2007,happily never after2007
4240,the ten,5250000,769726,786677,-4463323,0.14984323809523808,2007,the ten2007
3985,juno,7000000,143495265,231450102,224450102,33.06430028571429,2007,juno2007
1285,resident evil extinction,45000000,50648679,149871103,104871103,3.3304689555555558,2007,resident evil extinction2007
3295,resurrecting the champ,13000000,3172382,3260555,-9739445,0.25081192307692307,2007,resurrecting the champ2007
183,bee movie,150000000,126631277,287594577,137594577,1.91729718,2007,bee movie2007
5375,aqua teen hunger force colon movie film for theaters,750000,5520368,5520368,4770368,7.360490666666666,2007,aqua teen hunger force colon movie film for theaters2007
3125,blood and chocolate,15000000,3526588,6551310,-8448690,0.436754,2007,blood and chocolate2007
1186,eastern promises,50000000,17181265,56077088,6077088,1.12154176,2007,eastern promises2007
982,alvin and the chipmunks,55000000,217326974,362605033,307605033,6.592818781818182,2007,alvin and the chipmunks2007
3152,the good night,15000000,22441,22441,-14977559,0.0014960666666666666,2007,the good night2007
3211,le scaphandre et le papillon,14000000,5990075,22754472,8754472,1.6253194285714285,2007,le scaphandre et le papillon2007
1063,grindhouse,53000000,25031037,50187789,-2812211,0.9469394150943397,2007,grindhouse2007
2595,reign over me,20000000,19661987,20081987,81987,1.00409935,2007,reign over me2007
4138,daddy day camp,6000000,13235267,18209872,12209872,3.0349786666666665,2007,daddy day camp2007
153,transformers,151000000,319246193,708272592,557272592,4.690546966887418,2007,transformers2007
5456,finishing the game,500000,52850,53201,-446799,0.106402,2007,finishing the game2007
2611,dead silence,20000000,16574590,20614661,614661,1.03073305,2007,dead silence2007
2407,the game plan,22000000,90648202,146590987,124590987,6.663226681818182,2007,the game plan2007
4187,lake of fire,6000000,25317,26007,-5973993,0.0043345,2007,lake of fire2007
4067,high school musical 2,7000000,0,0,-7000000,0.0,2007,high school musical 22007
2401,1408,22500000,71985628,131263370,108763370,5.833927555555555,2007,14082007
160,i am legend,150000000,256393010,585532684,435532684,3.9035512266666665,2007,i am legend2007
157,harry potter and the order of the phoenix,150000000,292137260,943076457,793076457,6.28717638,2007,harry potter and the order of the phoenix2007
2597,georgia rule,20000000,18882880,20819601,819601,1.04098005,2007,georgia rule2007
4043,factory girl,7000000,1661464,1661464,-5338536,0.237352,2007,factory girl2007
2614,the kite runner,20000000,15800078,74180745,54180745,3.70903725,2007,the kite runner2007
3178,stomp the yard,14000000,61356221,75525718,61525718,5.394694142857142,2007,stomp the yard2007
3205,i think i love my wife,14000000,12559771,13205411,-794589,0.9432436428571429,2007,i think i love my wife2007
2600,into the wild,20000000,18354356,56822960,36822960,2.841148,2007,into the wild2007
136,shrek the third,160000000,322719944,807330936,647330936,5.04581835,2007,shrek the third2007
2079,how to lose friends  alienate people,28000000,2775593,12031443,-15968557,0.42969439285714284,2008,how to lose friends  alienate people2008
763,body of lies,67500000,39394666,118556530,51056530,1.756393037037037,2008,body of lies2008
221,the incredible hulk,137500000,134806913,265573859,128073859,1.9314462472727272,2008,the incredible hulk2008
4637,choke,3400000,2926565,4124277,724277,1.2130226470588235,2008,choke2008
2105,the duchess,27000000,13848978,45160110,18160110,1.6725966666666667,2008,the duchess2008
311,astãrix aux jeux olympiques,113500000,999811,132999811,19499811,1.171804502202643,2008,astãrix aux jeux olympiques2008
636,wanted,75000000,134508551,342416460,267416460,4.5655528,2008,wanted2008
2158,w,25100000,25534493,28575778,3475778,1.1384772111553785,2008,w2008
5095,my name is bruce,1500000,173066,173066,-1326934,0.11537733333333333,2008,my name is bruce2008
2164,gran torino,25000000,148095302,274543085,249543085,10.9817234,2008,gran torino2008
5089,snow angels,1500000,402858,414404,-1085596,0.2762693333333333,2008,snow angels2008
4756,ã lintãrieur,3000000,0,895932,-2104068,0.298644,2008,ã lintãrieur2008
2946,vicky cristina barcelona,16000000,23216709,104504817,88504817,6.5315510625,2008,vicky cristina barcelona2008
2084,welcome home roscoe jenkins,27500000,42436517,43607627,16107627,1.585731890909091,2008,welcome home roscoe jenkins2008
2977,good,16000000,31631,31631,-15968369,0.0019769375,2008,good2008
1919,meet the spartans,30000000,38233676,84646831,54646831,2.8215610333333334,2008,meet the spartans2008
5243,frozen river,1000000,2511476,6030129,5030129,6.030129,2008,frozen river2008
2974,bienvenue chez les chtis,16000000,1477650,247474497,231474497,15.4671560625,2008,bienvenue chez les chtis2008
2096,the sisterhood of the traveling pants 2,27000000,44089964,44270131,17270131,1.6396344814814814,2008,the sisterhood of the traveling pants 22008
2701,éæäè cj7,20000000,206678,47300771,27300771,2.36503855,2008,éæäè cj72008
5039,la misma luna,1700000,12590147,23271741,21571741,13.689259411764706,2008,la misma luna2008
5054,sukkar banat,1600000,1060591,14253760,12653760,8.9086,2008,sukkar banat2008
4746,the grand,3000000,115879,115879,-2884121,0.03862633333333333,2008,the grand2008
2745,sex drive,19000000,8402485,10412485,-8587515,0.5480255263157895,2008,sex drive2008
2901,how she move,17000000,7070641,8607815,-8392185,0.5063420588235295,2008,how she move2008
5233,shine a light,1000000,5505267,16173879,15173879,16.173879,2008,shine a light2008
241,kung fu panda,130000000,215434591,631910531,501910531,4.860850238461539,2008,kung fu panda2008
298,speed racer,120000000,43945766,93394462,-26605538,0.7782871833333334,2008,speed racer2008
4818,religulous,2500000,13011160,13881317,11381317,5.5525268,2008,religulous2008
4585,billy the early years of billy graham,3600000,320896,320896,-3279104,0.08913777777777777,2008,billy the early years of billy graham2008
2944,the women,16000000,26902075,50103808,34103808,3.131488,2008,the women2008
4401,obsluhoval jsem anglickãho krãle,4900000,617228,7174984,2274984,1.4642824489795918,2008,obsluhoval jsem anglickãho krãle2008
4639,august,3400000,12636,12636,-3387364,0.003716470588235294,2008,august2008
531,hellboy ii the golden army,82500000,75986503,160388063,77888063,1.9440977333333334,2008,hellboy ii the golden army2008
2003,genghis khan to the ends of the earth and sea,30000000,3892,4874498,-25125502,0.16248326666666665,2008,genghis khan to the ends of the earth and sea2008
4383,the cottage,5000000,0,1504960,-3495040,0.300992,2008,the cottage2008
4994,slacker uprising,2000000,0,0,-2000000,0.0,2008,slacker uprising2008
530,jumper,82500000,80172128,222640812,140140812,2.6986765090909093,2008,jumper2008
2663,strange wilderness,20000000,6575282,6947084,-13052916,0.3473542,2008,strange wilderness2008
4404,all hat,4900000,15198,15198,-4884802,0.0031016326530612245,2008,all hat2008
2347,zack and miri make a porno,24000000,31457946,36856306,12856306,1.5356794166666667,2008,zack and miri make a porno2008
912,righteous kill,60000000,40081410,78481410,18481410,1.3080235,2008,righteous kill2008
5004,man on wire,1900000,2962242,5617067,3717067,2.956351052631579,2008,man on wire2008
2858,step up 2 the streets,17500000,58017783,148586910,131086910,8.490680571428571,2008,step up 2 the streets2008
4808,silver medalist,2600000,0,0,-2600000,0.0,2008,silver medalist2008
4805,los cronocrãmenes,2600000,39127,564474,-2035526,0.21710538461538462,2008,los cronocrãmenes2008
4421,savage grace,4600000,434417,968805,-3631195,0.21060978260869564,2008,savage grace2008
892,the tale of despereaux,60000000,50877145,90482317,30482317,1.5080386166666666,2008,the tale of despereaux2008
4435,lãt den rãtte komma in,4500000,2122085,12247682,7747682,2.7217071111111113,2008,lãt den rãtte komma in2008
2023,frostnixon,29000000,18622031,28452945,-547055,0.9811360344827587,2008,frostnixon2008
5308,steppin the movie,1000000,0,0,-1000000,0.0,2008,steppin the movie2008
4375,stuck,5000000,67505,67505,-4932495,0.013501,2008,stuck2008
784,step brothers,65000000,100468793,128468793,63468793,1.9764429692307692,2008,step brothers2008
4560,purple violets,4000000,0,0,-4000000,0.0,2008,purple violets2008
4736,everybody wants to be italian,3000000,351416,351416,-2648584,0.11713866666666667,2008,everybody wants to be italian2008
2175,cloverfield,25000000,80048433,171302226,146302226,6.85208904,2008,cloverfield2008
2706,admiral,20000000,0,38585047,18585047,1.92925235,2008,admiral2008
253,australia,130000000,49554002,215080810,85080810,1.6544677692307692,2008,australia2008
2115,what just happened,27000000,1090947,2412123,-24587877,0.08933788888888888,2008,what just happened2008
350,10000 bc,105000000,94784201,269065678,164065678,2.5625302666666667,2008,10000 bc2008
2124,pineapple express,26000000,87341380,102404019,76404019,3.9386161153846153,2008,pineapple express2008
680,fools gold,72500000,70231041,109362966,36862966,1.5084547034482758,2008,fools gold2008
5179,extreme movie,1200000,0,81338,-1118662,0.06778166666666667,2008,extreme movie2008
4367,standard operating procedure,5000000,228830,332120,-4667880,0.066424,2008,standard operating procedure2008
170,madagascar escape 2 africa,150000000,180174880,599680774,449680774,3.9978718266666666,2008,madagascar escape 2 africa2008
2397,rogue,23000000,10452,4673377,-18326623,0.2031903043478261,2008,rogue2008
4969,eden lake,2000000,7321,4294373,2294373,2.1471865,2008,eden lake2008
4185,surfer dude,6000000,36497,36497,-5963503,0.006082833333333333,2008,surfer dude2008
4982,no mans land the rise of reeker,2000000,0,0,-2000000,0.0,2008,no mans land the rise of reeker2008
2848,i come with the rain,18000000,0,627422,-17372578,0.03485677777777778,2008,i come with the rain2008
4149,dolphins and whales tribes of the ocean 3d,6000000,7714996,17252287,11252287,2.8753811666666667,2008,dolphins and whales tribes of the ocean 3d2008
1100,yes man,50000000,97690976,225990976,175990976,4.51981952,2008,yes man2008
3086,the pirates who dont do anything a veggietales movie,15000000,12981269,13248444,-1751556,0.8832296,2008,the pirates who dont do anything a veggietales movie2008
3087,u2 3d,15000000,12898847,26170402,11170402,1.7446934666666667,2008,u2 3d2008
2284,stoploss,25000000,10915744,11229035,-13770965,0.4491614,2008,stoploss2008
2661,an american carol,20000000,7013191,7022183,-12977817,0.35110915,2008,an american carol2008
4829,brick lane,2500000,1094998,3838486,1338486,1.5353944,2008,brick lane2008
4358,american teen,5000000,942441,989319,-4010681,0.1978638,2008,american teen2008
5349,the hammer,850000,442638,442638,-407362,0.5207505882352941,2008,the hammer2008
4155,college,6000000,4694491,6176114,176114,1.0293523333333334,2008,college2008
5352,harrison montgomery,850000,0,0,-850000,0.0,2008,harrison montgomery2008
431,the spiderwick chronicles,92500000,71195053,162839667,70339667,1.7604288324324324,2008,the spiderwick chronicles2008
937,the spirit,60000000,19806188,39006188,-20993812,0.6501031333333334,2008,the spirit2008
4166,the wackness,6000000,2077046,3330012,-2669988,0.555002,2008,the wackness2008
878,the happening,60000000,64506874,162778384,102778384,2.7129730666666667,2008,the happening2008
948,in the name of the king a dungeon siege tale,60000000,4775656,13233220,-46766780,0.22055366666666668,2008,in the name of the king a dungeon siege tale2008
5428,fireproof,500000,33456317,33473297,32973297,66.946594,2008,fireproof2008
4834,fuel,2500000,174255,174255,-2325745,0.069702,2008,fuel2008
3111,in bruges,15000000,7800825,34533783,19533783,2.3022522,2008,in bruges2008
944,meet dave,60000000,11803254,50648806,-9351194,0.8441467666666667,2008,meet dave2008
2256,the ruins,25000000,17432844,22910563,-2089437,0.91642252,2008,the ruins2008
185,bolt,150000000,114053579,328015029,178015029,2.18676686,2008,bolt2008
3115,the rocker,15000000,6409528,8767338,-6232662,0.5844892,2008,the rocker2008
4341,bottle shock,5000000,4078607,4815890,-184110,0.963178,2008,bottle shock2008
4926,waltz with bashir,2000000,2283849,13912289,11912289,6.9561445,2008,waltz with bashir2008
4873,impact point,2200000,0,0,-2200000,0.0,2008,impact point2008
1067,mamma mia,52000000,144130063,615748772,563748772,11.841322538461538,2008,mamma mia2008
2269,fly me to the moon,25000000,14543943,43530281,18530281,1.74121124,2008,fly me to the moon2008
1017,the forbidden kingdom,55000000,52075270,129075270,74075270,2.346823090909091,2008,the forbidden kingdom2008
2639,be kind rewind,20000000,11175164,30894247,10894247,1.54471235,2008,be kind rewind2008
3135,funny games,15000000,1294640,8200127,-6799873,0.5466751333333333,2008,funny games2008
968,sex and the city,57500000,152647258,415247258,357747258,7.221691443478261,2008,sex and the city2008
3131,transsiberian,15000000,2203641,6379575,-8620425,0.425305,2008,transsiberian2008
967,che part 1 the argentine,58000000,1802521,31627370,-26372630,0.5452994827586207,2008,che part 1 the argentine2008
3173,slumdog millionaire,14000000,141330703,384530440,370530440,27.46646,2008,slumdog millionaire2008
2781,prom night,18000000,43869350,57193655,39193655,3.1774252777777776,2008,prom night2008
4306,the haunting of molly hartley,5000000,13442412,15318257,10318257,3.0636514,2008,the haunting of molly hartley2008
2827,mongol,18000000,5705761,27147349,9147349,1.5081860555555555,2008,mongol2008
2828,rocknrolla,18000000,5700626,27794339,9794339,1.5441299444444445,2008,rocknrolla2008
964,leatherheads,58000000,31373938,41348628,-16651372,0.7129073793103449,2008,leatherheads2008
457,valkyrie,90000000,83107829,203932174,113932174,2.2659130444444444,2008,valkyrie2008
1963,88 minutes,30000000,16930884,32955399,2955399,1.0985133,2008,88 minutes2008
162,hancock,150000000,227946274,624234272,474234272,4.161561813333333,2008,hancock2008
1966,pride and glory,30000000,15740721,43440721,13440721,1.4480240333333334,2008,pride and glory2008
5339,4 luni 3 saptamani si 2 zile,900000,1196321,11993156,11093156,13.32572888888889,2008,4 luni 3 saptamani si 2 zile2008
4876,jack brooks monster slayer,2150000,0,0,-2150000,0.0,2008,jack brooks monster slayer2008
1051,seven pounds,54000000,69951824,166617328,112617328,3.085506074074074,2008,seven pounds2008
4947,teeth,2000000,347578,2350641,350641,1.1753205,2008,teeth2008
3157,bathory,15000000,0,3436763,-11563237,0.22911753333333335,2008,bathory2008
452,you dont mess with the zohan,90000000,100018837,202910991,112910991,2.2545665666666665,2008,you dont mess with the zohan2008
449,tropic thunder,90000000,110515313,191145256,101145256,2.1238361777777777,2008,tropic thunder2008
4957,roadside romeo,2000000,55202,2046090,46090,1.023045,2008,roadside romeo2008
2390,the longshots,23000000,11511323,11778396,-11221604,0.5121041739130435,2008,the longshots2008
4233,animals,5500000,0,0,-5500000,0.0,2008,animals2008
2630,ghost town,20000000,13367624,29958228,9958228,1.4979114,2008,ghost town2008
3148,midnight meat train,15000000,73548,1590246,-13409754,0.1060164,2008,midnight meat train2008
2622,disaster movie,20000000,14190901,36720752,16720752,1.8360376,2008,disaster movie2008
1025,changeling,55000000,35739802,113805580,58805580,2.069192363636364,2008,changeling2008
493,horton hears a who,85000000,154529439,299477886,214477886,3.5232692470588236,2008,horton hears a who2008
4795,rejsen til saturn,2700000,0,5377665,2677665,1.9917277777777778,2008,rejsen til saturn2008
4836,the other end of the line,2500000,115504,507446,-1992554,0.2029784,2008,the other end of the line2008
4789,diary of the dead,2750000,952620,5394447,2644447,1.9616170909090909,2008,diary of the dead2008
2501,beverly hills chihuahua,20000000,94514402,154218168,134218168,7.7109084,2008,beverly hills chihuahua2008
4084,hannah montanamiley cyrus best of both worlds concert tour,6500000,65281781,70712099,64212099,10.878784461538462,2008,hannah montanamiley cyrus best of both worlds concert tour2008
1587,the express,37500000,9793406,9813309,-27686691,0.26168824,2008,the express2008
4037,redbelt,7000000,2344847,2667084,-4332916,0.381012,2008,redbelt2008
2572,one missed call,20000000,26890041,44513466,24513466,2.2256733,2008,one missed call2008
1862,27 dresses,30000000,76808654,160247805,130247805,5.3415935,2008,27 dresses2008
85,walle,180000000,223808164,532508025,352508025,2.9583779166666666,2008,walle2008
3928,pathology,8000000,109045,3270974,-4729026,0.40887175,2008,pathology2008
3733,white noise 2 the light,10000000,0,8243567,-1756433,0.8243567,2008,white noise 2 the light2008
3399,rachel getting married,12000000,12796861,17475475,5475475,1.4562895833333334,2008,rachel getting married2008
2557,doubt,20000000,33446470,53191101,33191101,2.65955505,2008,doubt2008
75,indiana jones and the kingdom of the crystal skull,185000000,317101119,786635413,601635413,4.252083313513514,2008,indiana jones and the kingdom of the crystal skull2008
3914,and when did you last see your father,8000000,1071240,2476491,-5523509,0.309561375,2008,and when did you last see your father2008
5582,happy valley,250000,67665,67665,-182335,0.27066,2008,happy valley2008
3324,the boy in the striped pyjamas,12500000,9046156,44083403,31583403,3.52667224,2008,the boy in the striped pyjamas2008
74,the dark knight,185000000,533720947,1001996207,816996207,5.416195713513513,2008,the dark knight2008
5636,yesterday was a lie,200000,0,0,-200000,0.0,2008,yesterday was a lie2008
1443,made of honor,40000000,46012734,106548738,66548738,2.66371845,2008,made of honor2008
1785,the reader,32500000,34194407,112964875,80464875,3.4758423076923077,2008,the reader2008
3772,the strangers,9000000,52597610,83051676,74051676,9.227964,2008,the strangers2008
73,iron man,186000000,318604126,585171547,399171547,3.1460835860215055,2008,iron man2008
1735,punisher war zone,35000000,8050977,10157534,-24842466,0.2902152571428571,2008,punisher war zone2008
3878,shutter,8000000,25928550,47782426,39782426,5.97280325,2008,shutter2008
2540,lakeview terrace,20000000,39263506,44821299,24821299,2.24106495,2008,lakeview terrace2008
5623,callresponse,200000,212989,212989,12989,1.064945,2008,callresponse2008
2536,meet the browns,20000000,41975388,41975388,21975388,2.0987694,2008,meet the browns2008
1756,black water transit,35000000,0,0,-35000000,0.0,2008,black water transit2008
3363,harold  kumar escape from guantanamo bay,12000000,38108728,43353117,31353117,3.61275975,2008,harold  kumar escape from guantanamo bay2008
3796,hamlet 2,9000000,4886216,4934104,-4065896,0.5482337777777778,2008,hamlet 22008
3468,high school musical 3 senior year,11000000,90559416,274392880,263392880,24.944807272727274,2008,high school musical 3 senior year2008
1319,miracle at st anna,45000000,7916887,9676497,-35323503,0.21503326666666667,2008,miracle at st anna2008
1668,max payne,35000000,40689393,87775050,52775050,2.5078585714285713,2008,max payne2008
2424,traitor,22000000,23530831,27882226,5882226,1.267373909090909,2008,traitor2008
3608,kit kittredge an american girl,10000000,17657973,17657973,7657973,1.7657973,2008,kit kittredge an american girl2008
1878,baby mama,30000000,60494212,64170447,34170447,2.1390149,2008,baby mama2008
5498,poultrygeist night of the chicken dead,450000,13804,22623,-427377,0.05027333333333334,2008,poultrygeist night of the chicken dead2008
1875,forgetting sarah marshall,30000000,63172463,105173042,75173042,3.5057680666666666,2008,forgetting sarah marshall2008
2475,swing vote,21000000,16289867,17589867,-3410133,0.8376127142857143,2008,swing vote2008
4069,stargate  the ark of truth,7000000,0,0,-7000000,0.0,2008,stargate  the ark of truth2008
2691,the children of huang shi,20000000,1031872,8221700,-11778300,0.411085,2008,the children of huang shi2008
4068,the kings of appletown,7000000,0,0,-7000000,0.0,2008,the kings of appletown2008
1410,vantage point,40000000,72266306,150886329,110886329,3.772158225,2008,vantage point2008
4082,tropa de elite,6537890,8744,14319195,7781305,2.190185977433086,2008,tropa de elite2008
142,the curious case of benjamin button,160000000,127509326,329631958,169631958,2.0601997375,2008,the curious case of benjamin button2008
1638,21,35000000,81159365,159846429,124846429,4.567040828571429,2008,212008
1639,what happens in vegas,35000000,80277646,218535708,183535708,6.243877371428572,2008,what happens in vegas2008
3516,saw v,10800000,56746769,118209778,107409778,10.945349814814815,2008,saw v2008
5770,the rise and fall of miss thang,10000,401,401,-9599,0.0401,2008,the rise and fall of miss thang2008
5457,kiss the bride,500000,32033,32033,-467967,0.064066,2008,kiss the bride2008
1600,space chimps,37000000,30105968,67029956,30029956,1.8116204324324325,2008,space chimps2008
4123,the wrestler,6000000,26238243,46634275,40634275,7.772379166666667,2008,the wrestler2008
1596,nims island,37000000,48006762,101857425,64857425,2.7529033783783783,2008,nims island2008
2596,my best friends girl,20000000,19219250,34787111,14787111,1.73935555,2008,my best friends girl2008
1594,burn after reading,37000000,60355347,168167798,131167798,4.5450756216216215,2008,burn after reading2008
5736,the legend of gods gun,30000,243768,243768,213768,8.1256,2008,the legend of gods gun2008
2592,appaloosa,20000000,20211394,27911453,7911453,1.39557265,2008,appaloosa2008
3479,the secret life of bees,11000000,37780486,39994347,28994347,3.6358497272727273,2008,the secret life of bees2008
1583,virgin territory,38000000,0,5473041,-32526959,0.14402739473684212,2008,virgin territory2008
4108,die fãlscher,6250000,5488570,20199663,13949663,3.23194608,2008,die fãlscher2008
3576,nick and norahs infinite playlist,10000000,31487293,33886017,23886017,3.3886017,2008,nick and norahs infinite playlist2008
1579,city of ember,38000000,7873007,17831558,-20168442,0.4692515263157895,2008,city of ember2008
3225,the lucky ones,14000000,266967,266967,-13733033,0.01906907142857143,2008,the lucky ones2008
3231,cah,13700000,0,11738256,-1961744,0.8568070072992701,2008,cah2008
3368,quarantine,12000000,31691811,41924774,29924774,3.4937311666666666,2008,quarantine2008
1531,delgo,40000000,915840,915840,-39084160,0.022896,2008,delgo2008
3848,repo the genetic opera,8500000,140244,198883,-8301117,0.023398,2008,repo the genetic opera2008
3964,witless protection,7500000,4151836,4151836,-3348164,0.5535781333333334,2008,witless protection2008
1301,babylon ad,45000000,22532572,70216497,25216497,1.5603666,2008,babylon ad2008
1697,superhero movie,35000000,26638520,73026302,38026302,2.0864657714285713,2008,superhero movie2008
1300,revolutionary road,45000000,22951340,79604820,34604820,1.768996,2008,revolutionary road2008
3696,my blueberry nights,10000000,866778,22198996,12198996,2.2198996,2008,my blueberry nights2008
2429,igor,22000000,19528602,31013349,9013349,1.409697681818182,2008,igor2008
1693,untraceable,35000000,28687835,52649951,17649951,1.5042843142857143,2008,untraceable2008
3701,war inc,10000000,580862,1299855,-8700145,0.1299855,2008,war inc2008
3831,star wars the clone wars,8500000,35161554,68695443,60195443,8.081816823529412,2008,star wars the clone wars2008
4931,son of rambow a home movie,2000000,1785505,11263263,9263263,5.6316315,2008,son of rambow a home movie2008
1030,semipro,55000000,33479698,43980363,-11019637,0.7996429636363637,2008,semipro2008
2674,passchendaele,20000000,4452423,4453327,-15546673,0.22266635,2008,passchendaele2008
2675,flash of genius,20000000,4442377,4504111,-15495889,0.22520555,2008,flash of genius2008
846,marley  me,60000000,143153751,247812011,187812011,4.130200183333334,2008,marley  me2008
549,get smart,80000000,130319208,226739416,146739416,2.8342427,2008,get smart2008
2042,role models,28000000,67300955,94500826,66500826,3.3750295,2008,role models2008
2761,ne le dis ã personne,18500000,6198883,33954018,15454018,1.8353523243243244,2008,ne le dis ã personne2008
833,the love guru,62000000,32235793,40159017,-21840983,0.6477260806451612,2008,the love guru2008
5292,special,1000000,7202,26822,-973178,0.026822,2008,special2008
2301,deception,25000000,4598506,12850033,-12149967,0.51400132,2008,deception2008
2679,synecdoche new york,20000000,3083538,4383538,-15616462,0.2191769,2008,synecdoche new york2008
4501,the visitor,4000000,9427026,19174817,15174817,4.79370425,2008,the visitor2008
2304,blindness,25000000,3073392,20052958,-4947042,0.80211832,2008,blindness2008
2197,the house bunny,25000000,48237389,71390601,46390601,2.85562404,2008,the house bunny2008
553,four christmases,80000000,120146040,168311558,88311558,2.103894475,2008,four christmases2008
5272,taxi to the dark side,1000000,274661,304472,-695528,0.304472,2008,taxi to the dark side2008
806,death race,65000000,36316032,72516819,7516819,1.1156433692307692,2008,death race2008
559,eagle eye,80000000,101440743,180585259,100585259,2.2573157375,2008,eagle eye2008
3370,the eye,12000000,31418697,57577765,45577765,4.798147083333333,2008,the eye2008
5700,the foot fist way,79000,234286,234286,155286,2.965645569620253,2008,the foot fist way2008
2567,the bank job,20000000,30060660,66143005,46143005,3.30715025,2008,the bank job2008
555,bedtime stories,80000000,110101975,221468935,141468935,2.7683616875,2008,bedtime stories2008
1471,transporter 3,40000000,31715062,107235592,67235592,2.6808898,2008,transporter 32008
3420,charlie bartlett,12000000,3950294,5295909,-6704091,0.44132575,2008,charlie bartlett2008
1778,doomsday,33000000,11008770,21621188,-11378812,0.6551875151515152,2008,doomsday2008
5607,little big top,240000,7484,7484,-232516,0.031183333333333334,2008,little big top2008
5591,sunday school musical,250000,0,0,-250000,0.0,2008,sunday school musical2008
5626,baghead,200000,140016,140016,-59984,0.70008,2008,baghead2008
3407,cadillac records,12000000,8195551,8942516,-3057484,0.7452096666666667,2008,cadillac records2008
2562,milk,20000000,31841299,57293371,37293371,2.86466855,2008,milk2008
1708,the xfiles i want to believe,35000000,20982478,68170792,33170792,1.9477369142857144,2008,the xfiles i want to believe2008
2574,street kings,20000000,26418667,65457811,45457811,3.27289055,2008,street kings2008
29,the chronicles of narnia prince caspian,225000000,141621490,417341288,192341288,1.854850168888889,2008,the chronicles of narnia prince caspian2008
3437,life before her eyes,12000000,303439,7203439,-4796561,0.6002865833333333,2008,life before her eyes2008
2427,mad money,22000000,20668843,25044057,3044057,1.1383662272727273,2008,mad money2008
2470,never back down,21000000,24850922,39319801,18319801,1.8723714761904762,2008,never back down2008
3996,definitely maybe,7000000,32241649,55617866,48617866,7.945409428571429,2008,definitely maybe2008
5629,good dick,200000,28835,52443,-147557,0.262215,2008,good dick2008
107,the mummy tomb of the dragon emperor,175000000,102491776,405760225,230760225,2.318629857142857,2008,the mummy tomb of the dragon emperor2008
1484,the other boleyn girl,40000000,26814957,78269970,38269970,1.95674925,2008,the other boleyn girl2008
1467,drillbit taylor,40000000,32862104,49686263,9686263,1.242156575,2008,drillbit taylor2008
3429,married life,12000000,1506998,2975188,-9024812,0.24793233333333334,2008,married life2008
1689,mirrors,35000000,30691439,77220596,42220596,2.206302742857143,2008,mirrors2008
3645,over her dead body,10000000,7570127,21596074,11596074,2.1596074,2008,over her dead body2008
25,quantum of solace,230000000,169368427,591692078,361692078,2.5725742521739132,2008,quantum of solace2008
1312,bangkok dangerous,45000000,15298133,46598133,1598133,1.0355140666666667,2008,bangkok dangerous2008
1513,soul men,40000000,12082391,12345883,-27654117,0.308647075,2008,soul men2008
5718,the signal,50000,251150,406299,356299,8.12598,2008,the signal2008
1230,rambo,47500000,42754105,112214531,64714531,2.3624111789473683,2008,rambo2008
5511,heroes,400000,655538,655538,255538,1.638845,2008,heroes2008
5544,wendy and lucy,300000,865695,1416046,1116046,4.720153333333333,2008,wendy and lucy2008
3656,run fatboy run,10000000,6003262,33512260,23512260,3.351226,2008,run fatboy run2008
1258,journey to the center of the earth,45000000,101704370,243180937,198180937,5.404020822222222,2008,journey to the center of the earth2008
1984,the imaginarium of doctor parnassus,30000000,7689607,64352607,34352607,2.1450869,2009,the imaginarium of doctor parnassus2009
1391,julie  julia,40000000,94125426,126646119,86646119,3.166152975,2009,julie  julia2009
1392,hes just not that into you,40000000,93953653,181053657,141053657,4.526341425,2009,hes just not that into you2009
5594,ink,250000,0,0,-250000,0.0,2009,ink2009
5608,bronson,230000,104979,2703762,2473762,11.75548695652174,2009,bronson2009
5248,the secrets of jonathan sperry,1000000,1355079,1355079,355079,1.355079,2009,the secrets of jonathan sperry2009
3830,crazy heart,8500000,39471742,47417251,38917251,5.578500117647059,2009,crazy heart2009
0,avatar,425000000,760507625,2776345279,2351345279,6.532577127058824,2009,avatar2009
3219,easy virtue,14000000,2656784,20537741,6537741,1.4669815,2009,easy virtue2009
2717,der baader meinhof komplex,19700000,476270,16498827,-3201173,0.8375039086294416,2009,der baader meinhof komplex2009
1378,the proposal,40000000,163958031,314709717,274709717,7.867742925,2009,the proposal2009
4532,adoration,4000000,294244,384244,-3615756,0.096061,2009,adoration2009
2476,away we go,21000000,9451946,10108016,-10891984,0.4813340952380952,2009,away we go2009
2814,i love you beth cooper,18000000,14800725,16382538,-1617462,0.910141,2009,i love you beth cooper2009
2625,crank 2 high voltage,20000000,13684249,35472739,15472739,1.77363695,2009,crank 2 high voltage2009
2394,coco avant chanel,23000000,6113834,50813834,27813834,2.209297130434783,2009,coco avant chanel2009
2620,capitalism a love story,20000000,14363397,19121531,-878469,0.95607655,2009,capitalism a love story2009
2395,chãri,23000000,2715657,2715657,-20284343,0.11807204347826086,2009,chãri2009
3085,whip it,15000000,13077184,18889972,3889972,1.2593314666666666,2009,whip it2009
2346,the men who stare at goats,24000000,32428195,67348218,43348218,2.80617575,2009,the men who stare at goats2009
2613,armored,20000000,15988876,23661038,3661038,1.1830519,2009,armored2009
3462,the cry of the owl,11500000,0,0,-11500000,0.0,2009,the cry of the owl2009
3463,st trinianâs,11400000,15000,29830239,18430239,2.6166876315789476,2009,st trinianâs2009
3076,the hurt locker,15000000,17017811,49894223,34894223,3.3262815333333333,2009,the hurt locker2009
2607,fired up,20000000,17231291,18608570,-1391430,0.9304285,2009,fired up2009
2244,fighting,25000000,23091010,32831707,7831707,1.31326828,2009,fighting2009
219,watchmen,138000000,107509799,186976250,48976250,1.3549003623188405,2009,watchmen2009
3944,christmas in beverly hills,8000000,0,0,-8000000,0.0,2009,christmas in beverly hills2009
5279,the house of the devil,1000000,101215,102812,-897188,0.102812,2009,the house of the devil2009
3228,stan helsing a parody,14000000,0,1553556,-12446444,0.11096828571428571,2009,stan helsing a parody2009
5134,the girlfriend experience,1300000,695840,1005840,-294160,0.773723076923077,2009,the girlfriend experience2009
3757,gentlemen broncos,9500000,115155,119955,-9380045,0.012626842105263159,2009,gentlemen broncos2009
5653,the horse boy,160000,156612,156612,-3388,0.978825,2009,the horse boy2009
3749,adventureland,9800000,16044025,17553055,7753055,1.7911280612244898,2009,adventureland2009
5104,pontypool,1500000,3865,31916,-1468084,0.021277333333333332,2009,pontypool2009
3742,good intentions,10000000,0,0,-10000000,0.0,2009,good intentions2009
3741,the devils tomb,10000000,0,0,-10000000,0.0,2009,the devils tomb2009
3740,adam resurrected,10000000,0,90909,-9909091,0.0090909,2009,adam resurrected2009
3815,flammen og citronen,9000000,148089,1635241,-7364759,0.18169344444444444,2009,flammen og citronen2009
3737,fifty dead men walking,10000000,0,997921,-9002079,0.0997921,2009,fifty dead men walking2009
70,disneyâs a christmas carol,190000000,137855863,315709697,125709697,1.6616299842105262,2009,disneyâs a christmas carol2009
812,astro boy,65000000,19551067,41636243,-23363757,0.6405575846153846,2009,astro boy2009
3844,bright star,8500000,4444637,17220091,8720091,2.0258930588235295,2009,bright star2009
910,planet 51,60000000,42194060,108996113,48996113,1.8166018833333333,2009,planet 512009
5306,the poker house,1000000,0,0,-1000000,0.0,2009,the poker house2009
906,year one,60000000,43337279,57604723,-2395277,0.9600787166666667,2009,year one2009
5303,frat party,1000000,0,0,-1000000,0.0,2009,frat party2009
876,michael jacksons this is it,60000000,72091016,252091016,192091016,4.201516933333333,2009,michael jacksons this is it2009
873,coraline,60000000,75286229,126037057,66037057,2.100617616666667,2009,coraline2009
4466,paa,4300000,199228,9791282,5491282,2.2770423255813954,2009,paa2009
851,couples retreat,60000000,109205660,172450423,112450423,2.8741737166666668,2009,couples retreat2009
1348,brã¼no,42000000,60054530,138708527,96708527,3.3025839761904763,2009,brã¼no2009
3895,the boondock saints 2 all saints day,8000000,10273187,10629320,2629320,1.328665,2009,the boondock saints 2 all saints day2009
3889,new in town,8000000,16734283,29937909,21937909,3.742238625,2009,new in town2009
206,star trek,140000000,257730019,386839614,246839614,2.7631401,2009,star trek2009
911,duplicity,60000000,40572825,81079566,21079566,1.3513261,2009,duplicity2009
3322,sorority row,12500000,11965282,26735797,14235797,2.13886376,2009,sorority row2009
2840,das weisse band eine deutsche kindergeschichte,18000000,2222862,25727044,7727044,1.4292802222222223,2009,das weisse band eine deutsche kindergeschichte2009
2730,i can do bad all by myself,19000000,51733921,51733921,32733921,2.722837947368421,2009,i can do bad all by myself2009
1979,dragonball evolution,30000000,9362785,58228460,28228460,1.9409486666666667,2009,dragonball evolution2009
3444,nanjing nanjing,12000000,122558,20122558,8122558,1.6768798333333332,2009,nanjing nanjing2009
1762,gake no ue no ponyo,34000000,15090399,205312666,171312666,6.038607823529412,2009,gake no ue no ponyo2009
2119,paul blart mall cop,26000000,146336178,185904750,159904750,7.150182692307692,2009,paul blart mall cop2009
3198,a perfect getaway,14000000,15515460,22815460,8815460,1.6296757142857143,2009,a perfect getaway2009
2238,dance flick,25000000,25794018,32224624,7224624,1.28898496,2009,dance flick2009
2265,the box,25000000,15051977,34356760,9356760,1.3742704,2009,the box2009
2670,bandslam,20000000,5210988,12967829,-7032171,0.64839145,2009,bandslam2009
2590,shorts,20000000,20919166,29870801,9870801,1.49354005,2009,shorts2009
3282,mãn som hatar kvinnor,13000000,12749992,109421911,96421911,8.417070076923077,2009,mãn som hatar kvinnor2009
1859,up in the air,30000000,83823381,166842739,136842739,5.561424633333333,2009,up in the air2009
2293,the road,25000000,8114270,29206732,4206732,1.16826928,2009,the road2009
2569,the stepfather,20000000,29062561,29227561,9227561,1.46137805,2009,the stepfather2009
3042,halloween 2,15000000,33392973,38512850,23512850,2.5675233333333334,2009,halloween 22009
2027,taking woodstock,29000000,7460204,10066366,-18933634,0.3471160689655172,2009,taking woodstock2009
2310,bad lieutenant port of call new orleans,25000000,1702112,12413949,-12586051,0.49655796,2009,bad lieutenant port of call new orleans2009
2312,me and orson welles,25000000,1190003,1190003,-23809997,0.04760012,2009,me and orson welles2009
3040,all about steve,15000000,33862903,40127259,25127259,2.6751506,2009,all about steve2009
1659,old dogs,35000000,49492060,95104304,60104304,2.7172658285714286,2009,old dogs2009
1642,hotel for dogs,35000000,73178547,122357172,87357172,3.4959192,2009,hotel for dogs2009
1846,district 9,30000000,115646235,212453431,182453431,7.081781033333334,2009,district 92009
3483,saw vi,11000000,27693292,69752402,58752402,6.341127454545455,2009,saw vi2009
2759,the invention of lying,18500000,18451251,32679264,14179264,1.7664467027027027,2009,the invention of lying2009
1861,hannah montana the movie,30000000,79576189,169173206,139173206,5.639106866666666,2009,hannah montana the movie2009
2537,orphan,20000000,41596251,78769428,58769428,3.9384714,2009,orphan2009
2952,jennifers body,16000000,16204793,31943401,15943401,1.9964625625,2009,jennifers body2009
2366,zombieland,23600000,75590286,102236596,78636596,4.332059152542373,2009,zombieland2009
2844,the informers,18000000,315000,315000,-17685000,0.0175,2009,the informers2009
2648,everybodys fine,20000000,9208876,9208876,-10791124,0.4604438,2009,everybodys fine2009
2083,my sisters keeper,27500000,49200230,96673002,69173002,3.515381890909091,2009,my sisters keeper2009
1664,underworld 3 rise of the lycans,35000000,45802315,89102315,54102315,2.5457804285714287,2009,underworld 3 rise of the lycans2009
2802,fame,18000000,22455510,80227619,62227619,4.457089944444444,2009,fame2009
2419,the informant,22000000,33316821,41771168,19771168,1.8986894545454545,2009,the informant2009
2801,love happens,18000000,22965110,36133014,18133014,2.0073896666666666,2009,love happens2009
1880,bride wars,30000000,58715510,115150424,85150424,3.838347466666667,2009,bride wars2009
2636,12 rounds,20000000,12234694,17306648,-2693352,0.8653324,2009,12 rounds2009
2799,observe and report,18000000,24007324,27148898,9148898,1.508272111111111,2009,observe and report2009
1909,drag me to hell,30000000,42100625,91388487,61388487,3.0462829,2009,drag me to hell2009
3448,1612,12000000,0,5400624,-6599376,0.450052,2009,16122009
2678,the brothers bloom,20000000,3531756,5531756,-14468244,0.2765878,2009,the brothers bloom2009
3146,ongbak 2,15000000,102458,7583050,-7416950,0.5055366666666666,2009,ongbak 22009
2511,obsessed,20000000,68261644,73964713,53964713,3.69823565,2009,obsessed2009
1727,the young victoria,35000000,11001272,31878891,-3121109,0.9108254571428571,2009,the young victoria2009
2899,my life in ruins,17000000,8677425,20477425,3477425,1.2045544117647058,2009,my life in ruins2009
3421,two lovers,12000000,3149034,16349034,4349034,1.3624195,2009,two lovers2009
2857,madea goes to jail,17500000,90508336,90508336,73008336,5.171904914285714,2009,madea goes to jail2009
2913,chasseurs de dragons,17000000,0,13446115,-3553885,0.7909479411764706,2009,chasseurs de dragons2009
2702,the burning plain,20000000,200730,1167092,-18832908,0.0583546,2009,the burning plain2009
2165,taken,25000000,145000989,226941585,201941585,9.0776634,2009,taken2009
1932,9,30000000,31749894,48559999,18559999,1.6186666333333333,2009,92009
2934,the unborn,16000000,42670410,78208812,62208812,4.88805075,2009,the unborn2009
3179,my bloody valentine,14000000,51545952,102836002,88836002,7.345428714285714,2009,my bloody valentine2009
3117,whatever works,15000000,5306706,35106706,20106706,2.3404470666666666,2009,whatever works2009
2140,brothers,26000000,28544157,45043870,19043870,1.7324565384615385,2009,brothers2009
3116,post grad,15000000,6382178,6563402,-8436598,0.4375601333333333,2009,post grad2009
1730,whiteout,35000000,10275638,12254746,-22745254,0.3501356,2009,whiteout2009
681,funny people,72500000,51855045,71880305,-619695,0.9914524827586206,2009,funny people2009
4658,adam,3200000,2283291,2834485,-365515,0.8857765625,2009,adam2009
5203,faith like potatoes,1100000,0,0,-1100000,0.0,2009,faith like potatoes2009
4838,sleep dealer,2500000,80136,108907,-2391093,0.0435628,2009,sleep dealer2009
1495,fantastic mr fox,40000000,21002919,47083412,7083412,1.1770853,2009,fantastic mr fox2009
19,harry potter and the halfblood prince,250000000,302089278,935213767,685213767,3.740855068,2009,harry potter and the halfblood prince2009
1603,obitaemyy ostrov,36500000,0,15000000,-21500000,0.410958904109589,2009,obitaemyy ostrov2009
372,cloudy with a chance of meatballs,100000000,124870275,236827677,136827677,2.36827677,2009,cloudy with a chance of meatballs2009
4881,rec,2100000,0,23266821,21166821,11.079438571428572,2009,rec2009
492,fast  furious,85000000,155064265,363064265,278064265,4.271344294117647,2009,fast  furious2009
4963,super capers,2000000,30955,30955,-1969045,0.0154775,2009,super capers2009
381,where the wild things are,100000000,77233467,99123656,-876344,0.99123656,2009,where the wild things are2009
358,public enemies,102500000,97104620,212282709,109782709,2.071050819512195,2009,public enemies2009
3553,precious based on the novel push by sapphire,10000000,47566524,68722848,58722848,6.8722848,2009,precious based on the novel push by sapphire2009
4762,chicago overcoat,3000000,0,0,-3000000,0.0,2009,chicago overcoat2009
4770,four single fathers,3000000,0,0,-3000000,0.0,2009,four single fathers2009
5028,deadline,1800000,0,0,-1800000,0.0,2009,deadline2009
501,itâs complicated,85000000,112735375,224614744,139614744,2.6425264,2009,itâs complicated2009
4855,niktã,2400000,0,1333891,-1066109,0.5557879166666667,2009,niktã2009
1569,push,38000000,31811527,49678401,11678401,1.3073263421052632,2009,push2009
4761,the deported,3000000,0,0,-3000000,0.0,2009,the deported2009
5103,trucker,1500000,52429,52429,-1447571,0.03495266666666667,2009,trucker2009
1111,knowing,50000000,79957634,186450317,136450317,3.72900634,2009,knowing2009
5662,a charlie brown christmas,150000,0,0,-150000,0.0,2009,a charlie brown christmas2009
4045,i hope they serve beer in hell,7000000,1429299,1429453,-5570547,0.20420757142857143,2009,i hope they serve beer in hell2009
4313,sunshine cleaning,5000000,12062558,17329337,12329337,3.4658674,2009,sunshine cleaning2009
184,gforce,150000000,119436770,292817841,142817841,1.95211894,2009,gforce2009
5367,dãd snã,800000,46742,2194020,1394020,2.742525,2009,dãd snã2009
3592,the fourth kind,10000000,26218170,49486874,39486874,4.9486874,2009,the fourth kind2009
391,land of the lost,100000000,49438370,69548641,-30451359,0.69548641,2009,land of the lost2009
1507,amelia,40000000,14279575,19756077,-20243923,0.493901925,2009,amelia2009
1508,cirque du freak the vampires assistant,40000000,14046595,39753957,-246043,0.993848925,2009,cirque du freak the vampires assistant2009
4650,entre les murs,3250000,3766810,34114067,30864067,10.496636,2009,entre les murs2009
441,sherlock holmes,90000000,209028679,498438212,408438212,5.538202355555556,2009,sherlock holmes2009
334,the taking of pelham 123,110000000,65452312,152364370,42364370,1.3851306363636364,2009,the taking of pelham 1232009
599,nine,80000000,19676965,53508858,-26491142,0.668860725,2009,nine2009
587,surrogates,80000000,38577772,119668350,39668350,1.495854375,2009,surrogates2009
1624,the hangover,35000000,277322503,465764086,430764086,13.307545314285715,2009,the hangover2009
3709,worlds greatest dad,10000000,221805,295750,-9704250,0.029575,2009,worlds greatest dad2009
442,ice age dawn of the dinosaurs,90000000,196573705,859701857,769701857,9.552242855555555,2009,ice age dawn of the dinosaurs2009
1625,the blind side,35000000,255959475,305705794,270705794,8.734451257142856,2009,the blind side2009
4700,the collector,3000000,7712114,10473836,7473836,3.4912786666666666,2009,the collector2009
349,the princess and the frog,105000000,104400899,270997378,165997378,2.5809274095238095,2009,the princess and the frog2009
3721,motherhood,10000000,93388,723388,-9276612,0.0723388,2009,motherhood2009
4318,not easily broken,5000000,10572742,10732909,5732909,2.1465818,2009,not easily broken2009
3713,free style,10000000,141108,721108,-9278892,0.0721108,2009,free style2009
3728,janky promoters,10000000,9069,9069,-9990931,0.0009069,2009,janky promoters2009
421,the lovely bones,95000000,44114232,94894448,-105552,0.9988889263157895,2009,the lovely bones2009
4965,the missing person,2000000,17896,17896,-1982104,0.008948,2009,the missing person2009
35,transformers revenge of the fallen,210000000,402111870,836519699,626519699,3.983427138095238,2009,transformers revenge of the fallen2009
1544,the time travelers wife,39000000,63414846,102332135,63332135,2.6239008974358975,2009,the time travelers wife2009
3620,the goods live hard sell hard,10000000,15122676,15297318,5297318,1.5297318,2009,the goods live hard sell hard2009
1534,red cliff,40000000,627047,119627047,79627047,2.990676175,2009,red cliff2009
5720,big things,50000,0,0,-50000,0.0,2009,big things2009
4692,next day air,3000000,10027047,10172519,7172519,3.3908396666666665,2009,next day air2009
1555,the ugly truth,38000000,88915214,205298907,167298907,5.402602815789474,2009,the ugly truth2009
4981,nine dead,2000000,0,0,-2000000,0.0,2009,nine dead2009
4974,lesbian vampire killers,2000000,0,3620902,1620902,1.810451,2009,lesbian vampire killers2009
3725,the open road,10000000,19716,19716,-9980284,0.0019716,2009,the open road2009
4023,a single man,7000000,9176000,28142379,21142379,4.020339857142857,2009,a single man2009
1516,pandorum,40000000,10330853,17033431,-22966569,0.425835775,2009,pandorum2009
1235,earth,47000000,32011576,116773317,69773317,2.484538659574468,2009,earth2009
4107,the damned united,6400000,449865,4199874,-2200126,0.6562303125,2009,the damned united2009
4100,the messenger,6500000,1109660,1744952,-4755048,0.26845415384615384,2009,the messenger2009
1164,defiance,50000000,28644813,52987754,2987754,1.05975508,2009,defiance2009
1038,imagine that,55000000,16222392,22438144,-32561856,0.40796625454545454,2009,imagine that2009
1171,the international,50000000,25450527,53850527,3850527,1.07701054,2009,the international2009
1181,gamer,50000000,20534907,42002029,-7997971,0.84004058,2009,gamer2009
171,xmen origins wolverine,150000000,179883157,374825760,224825760,2.4988384,2009,xmen origins wolverine2009
172,night at the museum battle of the smithsonian,150000000,177243721,402231063,252231063,2.68154042,2009,night at the museum battle of the smithsonian2009
5384,bled,750000,0,0,-750000,0.0,2009,bled2009
5381,donkey punch,750000,19367,814801,64801,1.0864013333333333,2009,donkey punch2009
180,angels  demons,150000000,133375846,490875846,340875846,3.27250564,2009,angels  demons2009
3958,an education,7500000,12574914,29652736,22152736,3.9536981333333334,2009,an education2009
1153,ninja assassin,50000000,38122883,62209892,12209892,1.24419784,2009,ninja assassin2009
100,up,175000000,293004164,731463377,556463377,4.179790725714286,2009,up2009
1411,i love you man,40000000,72013010,92302502,52302502,2.30756255,2009,i love you man2009
5237,food inc,1000000,4417674,4731944,3731944,4.731944,2009,food inc2009
1418,the final destination,40000000,66477700,187384627,147384627,4.684615675,2009,the final destination2009
4622,surveillance,3500000,27349,1396395,-2103605,0.39897,2009,surveillance2009
4625,the betrayed,3500000,0,0,-3500000,0.0,2009,the betrayed2009
1419,17 again,40000000,64167069,139474906,99474906,3.48687265,2009,17 again2009
60,terminator salvation,200000000,125322469,365491792,165491792,1.82745896,2009,terminator salvation2009
700,inglourious basterds,70000000,120774594,316915264,246915264,4.5273609142857145,2009,inglourious basterds2009
694,alvin and the chipmunks the squeakquel,70000000,219614612,443483213,373483213,6.335474471428571,2009,alvin and the chipmunks the squeakquel2009
58,2012,200000000,166112167,757677748,557677748,3.78838874,2009,20122009
4021,a serious man,7000000,9228788,30360570,23360570,4.337224285714286,2009,a serious man2009
5208,rocket singh salesman of the year,1070000,164649,5348767,4278767,4.998847663551402,2009,rocket singh salesman of the year2009
3954,500 days of summer,7500000,32425665,34439060,26939060,4.5918746666666665,2009,500 days of summer2009
4110,gomorra,6200000,1579146,37339594,31139594,6.022515161290323,2009,gomorra2009
4386,dead like me life after death,5000000,0,0,-5000000,0.0,2009,dead like me life after death2009
5403,starsuckers,640000,0,14812,-625188,0.02314375,2009,starsuckers2009
4336,moon,5000000,5010163,10676073,5676073,2.1352146,2009,moon2009
939,inkheart,60000000,17303424,66655938,6655938,1.1109323,2009,inkheart2009
5492,paranormal activity,450000,107918810,194183034,193733034,431.51785333333333,2009,paranormal activity2009
1202,outlander,50000000,166003,1250617,-48749383,0.02501234,2009,outlander2009
5356,crying with laughter,820000,0,16909,-803091,0.020620731707317073,2009,crying with laughter2009
105,gi joe the rise of cobra,175000000,150201498,302469017,127469017,1.7283943828571429,2009,gi joe the rise of cobra2009
103,monsters vs aliens,175000000,198351526,381687380,206687380,2.181070742857143,2009,monsters vs aliens2009
924,the soloist,60000000,31853584,38522450,-21477550,0.6420408333333333,2009,the soloist2009
914,state of play,60000000,37017955,88832210,28832210,1.4805368333333333,2009,state of play2009
913,invictus,60000000,37491364,124514011,64514011,2.0752335166666667,2009,invictus2009
4379,grace,5000000,8297,8297,-4991703,0.0016594,2009,grace2009
4382,flying by,5000000,0,4568257,-431743,0.9136514,2009,flying by2009
5533,royal kill,350000,0,0,-350000,0.0,2009,royal kill2009
3959,extract,7500000,10823158,10849158,3349158,1.4465544,2009,extract2009
1298,aliens in the attic,45000000,25200412,59551283,14551283,1.3233618444444444,2009,aliens in the attic2009
5355,london to brighton,825000,0,610776,-214224,0.7403345454545455,2009,london to brighton2009
1057,law abiding citizen,53000000,73357727,131159781,78159781,2.474712849056604,2009,law abiding citizen2009
4183,julia,6000000,65108,1365108,-4634892,0.227518,2009,julia2009
1081,the twilight saga new moon,50000000,296623634,687557727,637557727,13.75115454,2009,the twilight saga new moon2009
5459,home,500000,15433,44793168,44293168,89.586336,2009,home2009
1119,race to witch mountain,50000000,67172595,105103784,55103784,2.10207568,2009,race to witch mountain2009
5462,scott walker 30 century man,500000,6840,77121,-422879,0.154242,2009,scott walker 30 century man2009
4158,miss march,6000000,4543320,4713059,-1286941,0.7855098333333334,2009,miss march2009
966,did you hear about the morgans,58000000,29580087,80480566,22480566,1.3875959655172414,2009,did you hear about the morgans2009
1195,street fighter the legend of chunli,50000000,8742261,12660287,-37339713,0.25320574,2009,street fighter the legend of chunli2009
1198,the boat that rocked,50000000,8017467,37472651,-12527349,0.74945302,2009,the boat that rocked2009
4168,polytechnique,6000000,1418304,1418304,-4581696,0.236384,2009,polytechnique2009
4572,the good heart,3800000,20930,340930,-3459070,0.08971842105263157,2010,the good heart2010
5394,bgirl,700000,0,1160,-698840,0.0016571428571428572,2010,bgirl2010
3451,triangle,12000000,0,1594955,-10405045,0.13291291666666666,2010,triangle2010
2976,enter the void,16000000,337997,1467278,-14532722,0.091704875,2010,enter the void2010
2980,hachiko a dogs story,16000000,0,47707417,31707417,2.9817135625,2010,hachiko a dogs story2010
3570,devil,10000000,33679655,63354114,53354114,6.3354114,2010,devil2010
2106,case 39,27000000,13261851,28773827,1773827,1.0656972962962963,2010,case 392010
750,dinner for schmucks,69000000,73026337,86796502,17796502,1.2579203188405796,2010,dinner for schmucks2010
4448,afterlife,4500000,108596,2481925,-2018075,0.5515388888888889,2010,afterlife2010
2001,le petit nicolas,30000000,201857,52339566,22339566,1.7446522,2010,le petit nicolas2010
3126,you will meet a tall dark stranger,15000000,3247816,34247816,19247816,2.2831877333333335,2010,you will meet a tall dark stranger2010
3070,country strong,15000000,20218921,20601987,5601987,1.3734658,2010,country strong2010
38,robin hood,210000000,105487148,322459006,112459006,1.5355190761904762,2010,robin hood2010
752,the twilight saga eclipse,68000000,300531751,706102828,638102828,10.383865117647058,2010,the twilight saga eclipse2010
907,edge of darkness,60000000,43313890,82812456,22812456,1.3802076,2010,edge of darkness2010
4579,defendor,3750000,44462,44462,-3705538,0.011856533333333334,2010,defendor2010
5593,the christmas bunny,250000,0,0,-250000,0.0,2010,the christmas bunny2010
3641,macgruber,10000000,8525600,8629895,-1370105,0.8629895,2010,macgruber2010
4578,four lions,3750000,310007,2436111,-1313889,0.6496296,2010,four lions2010
129,how to train your dragon,165000000,217581232,494870992,329870992,2.999218133333333,2010,how to train your dragon2010
4351,rabbit hole,5000000,2229058,6205034,1205034,1.2410068,2010,rabbit hole2010
5471,drones,500000,0,0,-500000,0.0,2010,drones2010
4371,lovely still,5000000,127564,282687,-4717313,0.0565374,2010,lovely still2010
2497,jackass 3d,20000000,117229692,171685793,151685793,8.58428965,2010,jackass 3d2010
1591,the town,37000000,92186262,152566881,115566881,4.123429216216216,2010,the town2010
2637,let me in,20000000,12134935,28270399,8270399,1.41351995,2010,let me in2010
182,the last airbender,150000000,131772187,319713881,169713881,2.1314258733333333,2010,the last airbender2010
5760,breaking upwards,15000,115592,115592,100592,7.706133333333334,2010,breaking upwards2010
723,wall street 2 money never sleeps,70000000,52474616,137431619,67431619,1.9633088428571428,2010,wall street 2 money never sleeps2010
126,shrek forever after,165000000,238736787,756244673,591244673,4.583301048484849,2010,shrek forever after2010
5592,rust,250000,0,0,-250000,0.0,2010,rust2010
5530,my dog tulip,350000,246574,310891,-39109,0.88826,2010,my dog tulip2010
1390,the social network,40000000,96962694,224922135,184922135,5.623053375,2010,the social network2010
4443,life during wartime,4500000,281447,281447,-4218553,0.06254377777777778,2010,life during wartime2010
2550,the american,20000000,35606376,67950723,47950723,3.39753615,2010,the american2010
3866,easy a,8000000,58401464,76200721,68200721,9.525090125,2010,easy a2010
3335,the perfect game,12500000,1089445,3931367,-8568633,0.31450936,2010,the perfect game2010
4883,lies in plain sight,2100000,0,0,-2100000,0.0,2010,lies in plain sight2010
4968,circle,2000000,10024,10024,-1989976,0.005012,2010,circle2010
4047,mother and child,7000000,1110509,6537179,-462821,0.9338827142857142,2010,mother and child2010
397,green zone,100000000,35497337,97523020,-2476980,0.9752302,2010,green zone2010
5014,the last exorcism,1800000,41034350,70165900,68365900,38.98105555555556,2010,the last exorcism2010
4330,sea rex 3d journey to a prehistoric world,5000000,6096582,16515203,11515203,3.3030406,2010,sea rex 3d journey to a prehistoric world2010
4607,el secreto de sus ojos,3500000,6391436,40527719,37027719,11.579348285714286,2010,el secreto de sus ojos2010
114,iron man 2,170000000,312433331,621156389,451156389,3.653861111764706,2010,iron man 22010
4541,tau ming chong,4000000,129078,38899792,34899792,9.724948,2010,tau ming chong2010
783,due date,65000000,100539043,211739043,146739043,3.2575237384615385,2010,due date2010
3661,io sono lâamore,10000000,5005465,15121528,5121528,1.5121528,2010,io sono lâamore2010
147,the chronicles of narnia the voyage of the dawn treader,155000000,104386950,418186950,263186950,2.697980322580645,2010,the chronicles of narnia the voyage of the dawn treader2010
4402,soul kitchen,4900000,276901,23347461,18447461,4.764787959183673,2010,soul kitchen2010
2136,legion,26000000,40168080,67647574,41647574,2.6018297692307693,2010,legion2010
1598,cop out,37000000,44875481,55909910,18909910,1.5110786486486487,2010,cop out2010
4664,paranormal activity 2,3000000,84752907,177512032,174512032,59.17067733333333,2010,paranormal activity 22010
2579,alpha and omega 3d,20000000,25107267,48958353,28958353,2.44791765,2010,alpha and omega 3d2010
2466,for colored girls,21000000,37729698,38017873,17017873,1.8103749047619047,2010,for colored girls2010
2449,stone,22000000,1810078,4065020,-17934980,0.18477363636363636,2010,stone2010
3441,san qiang pai an jing qi,12000000,190946,310946,-11689054,0.025912166666666667,2010,san qiang pai an jing qi2010
2515,why did i get married too,20000000,60095852,60831067,40831067,3.04155335,2010,why did i get married too2010
5434,to save a life,500000,3777210,3824868,3324868,7.649736,2010,to save a life2010
190,the wolfman,150000000,62189884,142634358,-7365642,0.95089572,2010,the wolfman2010
1674,the backup plan,35000000,37490007,75281179,40281179,2.1508908285714288,2010,the backup plan2010
3434,ondine,12000000,550472,557545,-11442455,0.046462083333333334,2010,ondine2010
653,killers,75000000,47059963,95572749,20572749,1.27430332,2010,killers2010
2577,you again,20000000,25702053,32838945,12838945,1.64194725,2010,you again2010
2950,remember me,16000000,19068240,56506120,40506120,3.5316325,2010,remember me2010
749,despicable me,69000000,251513985,543464573,474464573,7.87629815942029,2010,despicable me2010
3012,diary of a wimpy kid,15000000,64003625,76954311,61954311,5.1302874,2010,diary of a wimpy kid2010
3059,ramona and beezus,15000000,26167002,27469621,12469621,1.8313080666666666,2010,ramona and beezus2010
862,red,60000000,90380162,196439693,136439693,3.273994883333333,2010,red2010
3598,skyline,10000000,21416355,68264973,58264973,6.8264973,2010,skyline2010
2566,daybreakers,20000000,30101577,51445503,31445503,2.57227515,2010,daybreakers2010
5538,kynodontas,323000,110248,1373407,1050407,4.252034055727554,2010,kynodontas2010
1962,splice,30000000,17010170,28542494,-1457506,0.9514164666666667,2010,splice2010
969,resident evil afterlife,57500000,60128566,295874190,238374190,5.145638086956522,2010,resident evil afterlife2010
143,the sorcerers apprentice,160000000,63150991,217986320,57986320,1.3624145,2010,the sorcerers apprentice2010
1652,secretariat,35000000,59699513,60376247,25376247,1.7250356285714286,2010,secretariat2010
3533,housefull,10100000,1183658,18726300,8626300,1.854089108910891,2010,housefull2010
1609,hot tub time machine,36000000,50269859,65967750,29967750,1.8324375,2010,hot tub time machine2010
2006,konferenz der tiere,30000000,0,53048539,23048539,1.7682846333333333,2010,konferenz der tiere2010
4451,spoken word,4500000,32961,32961,-4467039,0.007324666666666667,2010,spoken word2010
748,agora,70000000,619423,38992292,-31007708,0.5570327428571429,2010,agora2010
2548,vampires suck,20000000,36661504,81424988,61424988,4.0712494,2010,vampires suck2010
14,tangled,260000000,200821936,586477240,326477240,2.255681692307692,2010,tangled2010
5461,the living wake,500000,12232,12232,-487768,0.024464,2010,the living wake2010
2352,faster,24000000,23240020,35792945,11792945,1.4913727083333332,2010,faster2010
4735,fish tank,3000000,374675,5922292,2922292,1.9740973333333334,2010,fish tank2010
137,inception,160000000,292576195,835524642,675524642,5.2220290125,2010,inception2010
2906,lillusionniste,17000000,2231474,8609949,-8390051,0.5064675882352941,2010,lillusionniste2010
866,eat pray love,60000000,80574010,206598789,146598789,3.44331315,2010,eat pray love2010
4714,please give,3000000,4033574,4570178,1570178,1.5233926666666666,2010,please give2010
3732,the reef,10000000,0,15037867,5037867,1.5037867,2010,the reef2010
601,oceans,80000000,19422319,86787530,6787530,1.084844125,2010,oceans2010
2067,the spy next door,28000000,24307106,46752858,18752858,1.6697449285714285,2010,the spy next door2010
2561,shes out of my league,20000000,32010860,48680977,28680977,2.43404885,2010,shes out of my league2010
1472,morning glory,40000000,31011732,59795070,19795070,1.49487675,2010,morning glory2010
2514,the last song,20000000,62950384,92678948,72678948,4.6339474,2010,the last song2010
4724,letters to god,3000000,2848587,3237452,237452,1.0791506666666666,2010,letters to god2010
4041,somewhere,7000000,1785645,17023121,10023121,2.4318744285714287,2010,somewhere2010
1692,nanny mcphee and the big bang,35000000,29197642,97799865,62799865,2.794281857142857,2010,nanny mcphee and the big bang2010
5513,i want your money,400000,433588,433588,33588,1.08397,2010,i want your money2010
4745,the eclipse,3000000,133411,133411,-2866589,0.044470333333333334,2010,the eclipse2010
3730,the oxford murders,10000000,4803,17704131,7704131,1.7704131,2010,the oxford murders2010
2979,haeundae,16000000,0,64733391,48733391,4.0458369375,2010,haeundae2010
3128,never let me go,15000000,2434652,11173718,-3826282,0.7449145333333334,2010,never let me go2010
3467,the fighter,11000000,93617009,129262388,118262388,11.751126181818181,2010,the fighter2010
3687,the joneses,10000000,1475746,3541565,-6458435,0.3541565,2010,the joneses2010
2351,piranha 3d,24000000,25003155,83660160,59660160,3.48584,2010,piranha 3d2010
1628,true grit,35000000,171243005,252276928,217276928,7.207912228571429,2010,true grit2010
5564,andersons cross,300000,0,0,-300000,0.0,2010,andersons cross2010
3711,welcome to the rileys,10000000,152857,355919,-9644081,0.0355919,2010,welcome to the rileys2010
2176,dear john,25000000,80014842,142033509,117033509,5.68134036,2010,dear john2010
5566,death calls,290000,0,0,-290000,0.0,2010,death calls2010
4742,chain letter,3000000,205842,1022453,-1977547,0.3408176666666667,2010,chain letter2010
2053,kickass,28000000,48071303,97531134,69531134,3.4832547857142857,2010,kickass2010
3717,joheunnom nabbeunnom isanghannom,10000000,128486,42226657,32226657,4.2226657,2010,joheunnom nabbeunnom isanghannom2010
998,date night,55000000,98711404,152269033,97269033,2.768527872727273,2010,date night2010
4486,the kids are all right,4000000,20811365,36275469,32275469,9.06886725,2010,the kids are all right2010
4470,animal kingdom,4200000,1044039,8078683,3878683,1.9234959523809523,2010,animal kingdom2010
3719,blood done sign my name,10000000,109383,109383,-9890617,0.0109383,2010,blood done sign my name2010
633,grown ups,75000000,162001186,272223430,197223430,3.629645733333333,2010,grown ups2010
3720,the good guy,10000000,100688,106460,-9893540,0.010646,2010,the good guy2010
2988,the yellow handkerchief,15500000,318623,318623,-15181377,0.020556322580645162,2010,the yellow handkerchief2010
2889,lottery ticket,17000000,24719879,24719879,7719879,1.4541105294117647,2010,lottery ticket2010
5449,monsters,500000,237301,5639730,5139730,11.27946,2010,monsters2010
2887,brooklyns finest,17000000,27163593,39233233,22233233,2.3078372352941177,2010,brooklyns finest2010
4760,barry munday,3000000,0,0,-3000000,0.0,2010,barry munday2010
5309,zombies of mass destruction,1000000,0,0,-1000000,0.0,2010,zombies of mass destruction2010
4388,psych 9,5000000,0,0,-5000000,0.0,2010,psych 92010
2996,the kingâs speech,15000000,138797449,430821168,415821168,28.7214112,2010,the kingâs speech2010
1716,furry vengeance,35000000,17630465,39340177,4340177,1.124005057142857,2010,furry vengeance2010
46,toy story 3,200000000,415004880,1068879522,868879522,5.34439761,2010,toy story 32010
1563,life as we know it,38000000,53374681,105887837,67887837,2.7865220263157893,2010,life as we know it2010
4471,george a romeros survival of the dead,4200000,101740,101740,-4098260,0.024223809523809522,2010,george a romeros survival of the dead2010
3301,i love you phillip morris,13000000,2037459,23014027,10014027,1.7703097692307692,2010,i love you phillip morris2010
478,the nutcracker in 3d,90000000,195459,20466016,-69533984,0.22740017777777777,2010,the nutcracker in 3d2010
3300,un prophãte,13000000,2087720,19910624,6910624,1.5315864615384616,2010,un prophãte2010
2878,saw 3d,17000000,45710178,133735284,116735284,7.8667814117647055,2010,saw 3d2010
5009,the square,1900000,406216,740932,-1159068,0.3899642105263158,2010,the square2010
2693,middle men,20000000,754301,754301,-19245699,0.03771505,2010,middle men2010
551,shutter island,80000000,128012934,299461782,219461782,3.743272275,2010,shutter island2010
3384,just wright,12000000,21540363,21867665,9867665,1.8223054166666666,2010,just wright2010
3765,kites,9200000,1685269,17155193,7955193,1.8646948913043477,2010,kites2010
62,prince of persia sands of time,200000000,90759676,336359676,136359676,1.68179838,2010,prince of persia sands of time2010
3767,mine vaganti,9100000,0,18872126,9772126,2.07386,2010,mine vaganti2010
3158,san suk si gin,15000000,0,2013340,-12986660,0.13422266666666666,2010,san suk si gin2010
561,yogi bear,80000000,100246011,204774690,124774690,2.559683625,2010,yogi bear2010
5259,ajami,1000000,621859,2721096,1721096,2.721096,2010,ajami2010
533,the expendables,82000000,103068524,268268174,186268174,3.2715630975609757,2010,the expendables2010
2695,all good things,20000000,582024,873617,-19126383,0.04368085,2010,all good things2010
4212,rec 2,5600000,27766,18527766,12927766,3.3085296428571427,2010,rec 22010
4188,don mckay,6000000,13722,13722,-5986278,0.002287,2010,don mckay2010
4210,standing ovation,5600000,531806,531806,-5068194,0.09496535714285714,2010,standing ovation2010
384,the tourist,100000000,67631157,278731369,178731369,2.78731369,2010,the tourist2010
1421,get him to the greek,40000000,61153526,91455875,51455875,2.286396875,2010,get him to the greek2010
249,salt,130000000,118311368,290650494,160650494,2.2357730307692307,2010,salt2010
246,megamind,130000000,148415853,321887208,191887208,2.476055446153846,2010,megamind2010
4190,icarus,6000000,0,0,-6000000,0.0,2010,icarus2010
1074,from paris with love,52000000,24077427,53139168,1139168,1.021907076923077,2010,from paris with love2010
5005,nowhere boy,1900000,1445366,7785229,5885229,4.097488947368421,2010,nowhere boy2010
521,scott pilgrim vs the world,85000000,31611316,48056764,-36943236,0.565373694117647,2010,scott pilgrim vs the world2010
4026,cyrus,7000000,7468936,10062896,3062896,1.4375565714285714,2010,cyrus2010
3748,gunless,9900000,458054,458054,-9441946,0.04626808080808081,2010,gunless2010
389,legend of the guardians the owls of gahoole,100000000,55675313,139716717,39716717,1.39716717,2010,legend of the guardians the owls of gahoole2010
1434,predators,40000000,52000688,127234389,87234389,3.180859725,2010,predators2010
4206,valhalla rising,5700000,30638,731613,-4968387,0.12835315789473684,2010,valhalla rising2010
4779,freakonomics,2900000,101270,172867,-2727133,0.05960931034482759,2010,freakonomics2010
1832,extraordinary measures,31000000,12482741,15826984,-15173016,0.5105478709677419,2010,extraordinary measures2010
2700,the tempest,20000000,277943,277943,-19722057,0.01389715,2010,the tempest2010
3980,harry brown,7300000,1818681,12023606,4723606,1.6470693150684932,2010,harry brown2010
1272,the bounty hunter,45000000,67061228,135808837,90808837,3.0179741555555557,2010,the bounty hunter2010
312,gullivers travels,112000000,42779261,232017848,120017848,2.0715879285714287,2010,gullivers travels2010
1948,the next three days,30000000,21148651,67255916,37255916,2.241863866666667,2010,the next three days2010
1250,arthur and the war of two worlds,45500000,347136,36180824,-9319176,0.795182945054945,2010,arthur and the war of two worlds2010
563,the book of eli,80000000,94835059,158750817,78750817,1.9843852125,2010,the book of eli2010
516,cats  dogs the revenge of kitty galore,85000000,43585753,113026383,28026383,1.3297221529411765,2010,cats  dogs the revenge of kitty galore2010
5001,buried,1987650,1044143,21270290,19282640,10.701225064774986,2010,buried2010
3808,princess kaiulani,9000000,883887,883887,-8116113,0.09820966666666667,2010,princess kaiulani2010
5289,16 to life,1000000,11574,11574,-988426,0.011574,2010,16 to life2010
2708,three kingdoms resurrection of the dragon,20000000,0,22139590,2139590,1.1069795,2010,three kingdoms resurrection of the dragon2010
5206,the dead undead,1100000,0,0,-1100000,0.0,2010,the dead undead2010
3812,la fille du rer,9000000,208163,208163,-8791837,0.02312922222222222,2010,la fille du rer2010
2846,carlos,18000000,145526,1619153,-16380847,0.08995294444444445,2010,carlos2010
1023,burlesque,55000000,39440655,90552675,35552675,1.6464122727272728,2010,burlesque2010
3814,red riding the year of our lord 1974,9000000,148826,148826,-8851174,0.016536222222222223,2010,red riding the year of our lord 19742010
3756,the runaways,9500000,3573673,5278632,-4221368,0.5556454736842106,2010,the runaways2010
5204,lake mungo,1100000,0,0,-1100000,0.0,2010,lake mungo2010
373,the other guys,100000000,119219978,170936470,70936470,1.7093647,2010,the other guys2010
4151,city island,6000000,6671283,8173486,2173486,1.3622476666666667,2010,city island2010
4844,christmas mail,2500000,0,0,-2500000,0.0,2010,christmas mail2010
3735,its a wonderful afterlife,10000000,0,1642939,-8357061,0.1642939,2010,its a wonderful afterlife2010
3145,centurion,15000000,123570,7885048,-7114952,0.5256698666666667,2010,centurion2010
4837,8 the mormon proposition,2500000,100280,100280,-2399720,0.040112,2010,8 the mormon proposition2010
4181,the greatest,6000000,115862,117796,-5882204,0.019632666666666666,2010,the greatest2010
263,harry potter and the deathly hallows part i,125000000,296131568,960431568,835431568,7.683452544,2010,harry potter and the deathly hallows part i2010
4835,valley of the hearts delight,2500000,118666,118666,-2381334,0.0474664,2010,valley of the hearts delight2010
1928,love and other drugs,30000000,32367005,102716321,72716321,3.423877366666667,2010,love and other drugs2010
4022,get low,7000000,9176933,10828305,3828305,1.5469007142857143,2010,get low2010
1239,jonah hex,47000000,10547117,11022696,-35977304,0.23452544680851065,2010,jonah hex2010
5597,butterfly,250000,0,0,-250000,0.0,2010,butterfly2010
3816,leaves of grass,9000000,70066,85527,-8914473,0.009503,2010,leaves of grass2010
5036,i spit on your grave,1750000,93051,1278471,-471529,0.7305548571428572,2010,i spit on your grave2010
1069,valentines day,52000000,110485654,217569328,165569328,4.184025538461539,2010,valentines day2010
5717,tiny furniture,50000,391674,424149,374149,8.48298,2010,tiny furniture2010
3194,our family wedding,14000000,20255281,21410546,7410546,1.5293247142857143,2010,our family wedding2010
3310,the killer inside me,13000000,217277,3617277,-9382723,0.2782520769230769,2010,the killer inside me2010
3913,made in dagenham,8000000,1095369,15644196,7644196,1.9555245,2010,made in dagenham2010
3331,casino jack,12500000,2039869,2272186,-10227814,0.18177488,2010,casino jack2010
415,sex and the city 2,95000000,95347692,294680778,199680778,3.1019029263157893,2010,sex and the city 22010
2321,belka i strelka zvezdnye sobaki,25000000,0,9445081,-15554919,0.37780324,2010,belka i strelka zvezdnye sobaki2010
3856,the city of your final destination,8300000,493296,1353296,-6946704,0.1630477108433735,2010,the city of your final destination2010
300,how do you know,120000000,30212620,49628177,-70371823,0.41356814166666667,2010,how do you know2010
2243,the losers,25000000,23591432,29863840,4863840,1.1945536,2010,the losers2010
5144,the 41yearold virgin who knocked up sarah marshall and felt superbad about it,1300000,0,0,-1300000,0.0,2010,the 41yearold virgin who knocked up sarah marshall and felt superbad about it2010
4970,jerusalema,2000000,7294,10679,-1989321,0.0053395,2010,jerusalema2010
3851,my name is khan,8470000,4046336,42355526,33885526,5.000652420306966,2010,my name is khan2010
5053,nsecure,1600000,2595644,2595644,995644,1.6222775,2010,nsecure2010
301,knight and day,117000000,76423035,258751370,141751370,2.211550170940171,2010,knight and day2010
1310,the ghost writer,45000000,15541549,65532491,20532491,1.4562775777777779,2010,the ghost writer2010
1810,going the distance,32000000,17804299,43603990,11603990,1.3626246875,2010,going the distance2010
1812,repo men,32000000,13942007,18195238,-13804762,0.5686011875,2010,repo men2010
2824,the last station,18000000,6617867,15696146,-2303854,0.8720081111111111,2010,the last station2010
1222,tooth fairy,48000000,60022256,112610386,64610386,2.346049708333333,2010,tooth fairy2010
3927,wild target,8000000,109338,5314194,-2685806,0.66427425,2010,wild target2010
2830,maos last dancer,18000000,4806750,25941437,7941437,1.4411909444444444,2010,maos last dancer2010
1908,step up 3d,30000000,42400223,165889117,135889117,5.529637233333333,2010,step up 3d2010
369,little fockers,100000000,148438600,310650574,210650574,3.10650574,2010,little fockers2010
3296,chloe,13000000,3075255,11831131,-1168869,0.910087,2010,chloe2010
2812,youth in revolt,18000000,15285588,19685588,1685588,1.0936437777777779,2010,youth in revolt2010
1160,hereafter,50000000,32746941,108660270,58660270,2.1732054,2010,hereafter2010
1158,marmaduke,50000000,33644788,89895930,39895930,1.7979186,2010,marmaduke2010
5125,my girlfriends boyfriend,1400000,0,0,-1400000,0.0,2010,my girlfriends boyfriend2010
3221,flipped,14000000,1755212,4289993,-9710007,0.3064280714285714,2010,flipped2010
5224,blue valentine,1000000,9737892,16566240,15566240,16.56624,2010,blue valentine2010
3245,black swan,13000000,106954678,331266710,318266710,25.482054615384616,2010,black swan2010
4943,the virginity hit,2000000,636706,636706,-1363294,0.318353,2010,the virginity hit2010
4954,saint john of las vegas,2000000,102645,102645,-1897355,0.0513225,2010,saint john of las vegas2010
4081,perrierâs bounty,6600000,828,828,-6599172,0.00012545454545454546,2010,perrierâs bounty2010
57,tron legacy,200000000,172062763,400062763,200062763,2.000313815,2010,tron legacy2010
1794,takers,32000000,57744720,70587268,38587268,2.205852125,2010,takers2010
5096,the disappearance of alice creed,1500000,166980,1605139,105139,1.0700926666666666,2010,the disappearance of alice creed2010
418,unstoppable,95000000,81562942,165720921,70720921,1.744430747368421,2010,unstoppable2010
416,percy jackson  the olympians the lightning thief,95000000,88768303,223050874,128050874,2.3479039368421053,2010,percy jackson  the olympians the lightning thief2010
2738,the switch,19000000,27758465,49858465,30858465,2.624129736842105,2010,the switch2010
4907,winters bone,2000000,6531503,16131551,14131551,8.0657755,2010,winters bone2010
2320,sammys avonturen de geheime doorgang,25000000,0,71594792,46594792,2.86379168,2010,sammys avonturen de geheime doorgang2010
2739,leap year,19000000,25918920,32618920,13618920,1.7167852631578948,2010,leap year2010
1888,letters to juliet,30000000,53032453,82148538,52148538,2.7382846,2010,letters to juliet2010
3327,conviction,12500000,6797696,11826980,-673020,0.9461584,2010,conviction2010
3223,les herbes folles,14000000,403952,1903952,-12096048,0.13599657142857144,2010,les herbes folles2010
3329,solitary man,12500000,4360548,4360548,-8139452,0.34884384,2010,solitary man2010
1364,the warriors way,42000000,5666340,8514325,-33485675,0.2027220238095238,2010,the warriors way2010
3900,its kind of a funny story,8000000,6363628,6632950,-1367050,0.82911875,2010,its kind of a funny story2010
2805,127 hours,18000000,18335230,60217171,42217171,3.345398388888889,2010,127 hours2010
2735,the crazies,19000000,39123589,56445534,37445534,2.9708175789473685,2010,the crazies2010
4052,the extra man,7000000,453377,492108,-6507892,0.07030114285714285,2010,the extra man2010
4079,bran nue dae,6750000,113568,6812530,62530,1.0092637037037038,2010,bran nue dae2010
1366,micmacs,42000000,1259693,11756922,-30243078,0.2799267142857143,2010,micmacs2010
2267,my soul to take,25000000,14744435,16727470,-8272530,0.6690988,2010,my soul to take2010
3916,the secret of kells,8000000,690290,3582797,-4417203,0.447849625,2010,the secret of kells2010
1330,charlie st cloud,44000000,31206263,48478084,4478084,1.1017746363636363,2010,charlie st cloud2010
5740,down terrace,30000,9812,9812,-20188,0.32706666666666667,2010,down terrace2010
4075,incendies,6800000,6857096,16038343,9238343,2.3585798529411766,2010,incendies2010
331,the ateam,110000000,77222099,177241171,67241171,1.6112833727272726,2010,the ateam2010
3317,machete,12500000,26593646,46370970,33870970,3.7096776,2010,machete2010
5730,the exploding girl,40000,25572,25572,-14428,0.6393,2010,the exploding girl2010
3907,another year,8000000,3205706,20005613,12005613,2.500701625,2010,another year2010
4916,inside job,2000000,4311834,7799257,5799257,3.8996285,2010,inside job2010
2318,love ranch,25000000,137885,146149,-24853851,0.00584596,2010,love ranch2010
1488,season of the witch,40000000,24827228,91126600,51126600,2.278165,2011,season of the witch2011
3677,bucky larson born to be a star,10000000,2529395,2529395,-7470605,0.2529395,2011,bucky larson born to be a star2011
1675,j edgar,35000000,37306030,84606030,49606030,2.417315142857143,2011,j edgar2011
2323,la vãritable histoire du chat bottã,25000000,0,8208594,-16791406,0.32834376,2011,la vãritable histoire du chat bottã2011
197,mission impossibleâghost protocol,145000000,209397903,694713230,549713230,4.791125724137931,2011,mission impossibleâghost protocol2011
1753,trespass,35000000,16816,786532,-34213468,0.022472342857142856,2011,trespass2011
5601,rock the house,250000,0,0,-250000,0.0,2011,rock the house2011
3924,restless,8000000,163753,2772511,-5227489,0.346563875,2011,restless2011
1576,the thing,38000000,16999934,27573078,-10426922,0.7256073157894737,2011,the thing2011
5358,jodaeiye nader az simin,800000,7098492,24426169,23626169,30.53271125,2011,jodaeiye nader az simin2011
330,real steel,110000000,85463309,263880341,153880341,2.398912190909091,2011,real steel2011
1469,extremely loud and incredibly close,40000000,31847881,55247881,15247881,1.381197025,2011,extremely loud and incredibly close2011
193,mars needs moms,150000000,21392758,39549758,-110450242,0.26366505333333334,2011,mars needs moms2011
3683,a better life,10000000,1759252,1884251,-8115749,0.1884251,2011,a better life2011
266,fast five,125000000,210031325,630163454,505163454,5.041307632,2011,fast five2011
5177,certifiably jonathan,1200000,7826,7826,-1192174,0.006521666666666667,2011,certifiably jonathan2011
260,harry potter and the deathly hallows part ii,125000000,381193157,1341693157,1216693157,10.733545256,2011,harry potter and the deathly hallows part ii2011
268,sherlock holmes a game of shadows,125000000,186848418,535663443,410663443,4.285307544,2011,sherlock holmes a game of shadows2011
3431,kill the irishman,12000000,1188194,1188194,-10811806,0.09901616666666667,2011,kill the irishman2011
2324,ironclad,25000000,0,5297411,-19702589,0.21189644,2011,ironclad2011
2375,the ides of march,23000000,40962534,77735925,54735925,3.3798228260869565,2011,the ides of march2011
5374,kevin hart laugh at my pain,750000,7706436,7712436,6962436,10.283248,2011,kevin hart laugh at my pain2011
3446,5 days of war,12000000,17479,87793,-11912207,0.007316083333333333,2011,5 days of war2011
3650,cedar rapids,10000000,6861102,7862131,-2137869,0.7862131,2011,cedar rapids2011
5731,raymond did it,40000,3632,3632,-36368,0.0908,2011,raymond did it2011
3450,tu xia chuan qi,12000000,0,1828400,-10171600,0.15236666666666668,2011,tu xia chuan qi2011
2722,the devils double,19100000,1361512,5965646,-13134354,0.3123374869109948,2011,the devils double2011
3825,ultramarines,8900000,0,0,-8900000,0.0,2011,ultramarines2011
256,the twilight saga breaking dawn part 1,127500000,281287133,689420051,561920051,5.40721608627451,2011,the twilight saga breaking dawn part 12011
141,xmen first class,160000000,146408305,355408305,195408305,2.22130190625,2011,xmen first class2011
328,the green hornet,110000000,98780042,229155503,119155503,2.0832318454545455,2011,the green hornet2011
1114,moneyball,50000000,75605492,111300835,61300835,2.2260167,2011,moneyball2011
1757,the darkest hour,34800000,21443494,62831715,28031715,1.805509051724138,2011,the darkest hour2011
2242,dont be afraid of the dark,25000000,24046682,39126427,14126427,1.56505708,2011,dont be afraid of the dark2011
709,battle los angeles,70000000,83552429,213463976,143463976,3.0494853714285712,2011,battle los angeles2011
1985,barneys version,30000000,7502560,8845575,-21154425,0.2948525,2011,barneys version2011
4863,redemption road,2300000,29384,29384,-2270616,0.012775652173913044,2011,redemption road2011
4780,griff the invisible,2900000,20778,25935,-2874065,0.008943103448275862,2011,griff the invisible2011
4542,trust,4000000,120016,120016,-3879984,0.030004,2011,trust2011
3621,my week with marilyn,10000000,14597405,34240572,24240572,3.4240572,2011,my week with marilyn2011
1373,the big year,41000000,7204138,7684524,-33315476,0.18742741463414633,2011,the big year2011
1784,bridesmaids,32500000,169211718,289632023,257132023,8.911754553846153,2011,bridesmaids2011
5111,the lion of judah,1500000,0,0,-1500000,0.0,2011,the lion of judah2011
2726,bad teacher,19000000,100292856,215448997,196448997,11.339420894736842,2011,bad teacher2011
245,puss in boots,130000000,149260504,554987477,424987477,4.269134438461538,2011,puss in boots2011
5438,sholem aleichem laughing in the darkness,500000,1131261,1131261,631261,2.262522,2011,sholem aleichem laughing in the darkness2011
319,the smurfs,110000000,142614158,563749323,453749323,5.124993845454545,2011,the smurfs2011
1354,red riding hood,42000000,37662162,91678442,49678442,2.182820047619048,2011,red riding hood2011
1562,water for elephants,38000000,58709717,116809717,78809717,3.0739399210526317,2011,water for elephants2011
3896,prom,8000000,10130219,10763183,2763183,1.345397875,2011,prom2011
1671,something borrowed,35000000,39046489,65084116,30084116,1.8595461714285715,2011,something borrowed2011
1424,the lincoln lawyer,40000000,58009200,87145086,47145086,2.17862715,2011,the lincoln lawyer2011
3872,5050,8000000,35016118,41334735,33334735,5.166841875,2011,50502011
1341,the mechanic,42500000,29121498,76347393,33847393,1.7964092470588235,2011,the mechanic2011
5093,amigo,1500000,184705,184705,-1315295,0.12313666666666667,2011,amigo2011
5454,rubber,500000,100370,680914,180914,1.361828,2011,rubber2011
1795,source code,32000000,54712227,140428499,108428499,4.38839059375,2011,source code2011
1466,arthur,40000000,33035397,47787943,7787943,1.194698575,2011,arthur2011
5091,moozlum,1500000,362239,372239,-1127761,0.24815933333333334,2011,moozlum2011
1673,in time,35000000,37553932,165103952,130103952,4.717255771428571,2011,in time2011
5758,the ridges,17300,0,0,-17300,0.0,2011,the ridges2011
2564,the debt,20000000,31177548,46604054,26604054,2.3302027,2011,the debt2011
2399,shi yue wei cheng,23000000,0,44195779,21195779,1.9215556086956522,2011,shi yue wei cheng2011
3766,red dog,9100000,0,20927794,11827794,2.299757582417582,2011,red dog2011
1620,there be dragons,36000000,1069334,4020990,-31979010,0.11169416666666666,2011,there be dragons2011
88,hugo,180000000,73864507,180047784,47784,1.0002654666666666,2011,hugo2011
3393,young adult,12000000,16311571,22750356,10750356,1.895863,2011,young adult2011
3736,you got served beat the world,10000000,0,1230542,-8769458,0.1230542,2011,you got served beat the world2011
1318,johnny english reborn,45000000,8406711,164640401,119640401,3.6586755777777777,2011,johnny english reborn2011
3761,melancholia,9400000,3030848,21817298,12417298,2.32098914893617,2011,melancholia2011
1592,dolphin tale,37000000,72286779,96068724,59068724,2.596452,2011,dolphin tale2011
1743,biutiful,35000000,5101237,24687524,-10312476,0.7053578285714286,2011,biutiful2011
1454,scream 4,40000000,38180928,95989590,55989590,2.39973975,2011,scream 42011
1459,colombiana,40000000,36665854,72295262,32295262,1.80738155,2011,colombiana2011
3933,fireflies in the garden,8000000,36884,3587191,-4412809,0.448398875,2011,fireflies in the garden2011
3309,in the land of blood and honey,13000000,303877,509193,-12490807,0.03916869230769231,2011,in the land of blood and honey2011
5550,3 backyards,300000,39475,39475,-260525,0.13158333333333333,2011,3 backyards2011
1800,big mommas like father like son,32000000,37915414,82332450,50332450,2.5728890625,2011,big mommas like father like son2011
2552,a very harold  kumar 3d christmas,20000000,35061031,36265745,16265745,1.81328725,2011,a very harold  kumar 3d christmas2011
5024,higher ground,1800000,841056,842693,-957307,0.46816277777777776,2011,higher ground2011
3306,attack the block,13000000,1024175,6459183,-6540817,0.49686023076923075,2011,attack the block2011
3992,jumping the broom,7000000,37295394,38158601,31158601,5.4512287142857145,2011,jumping the broom2011
5062,insidious,1500000,54009150,99870886,98370886,66.58059066666667,2011,insidious2011
5241,martha marcy may marlene,1000000,2981038,5438911,4438911,5.438911,2011,martha marcy may marlene2011
3510,brighton rock,11000000,229653,229653,-10770347,0.020877545454545454,2011,brighton rock2011
2689,dylan dog dead of night,20000000,1186538,6093725,-13906275,0.30468625,2011,dylan dog dead of night2011
2504,the descendants,20000000,82624961,175507800,155507800,8.77539,2011,the descendants2011
1457,paul,40000000,37412945,101162106,61162106,2.52905265,2011,paul2011
232,happy feet two,135000000,64006466,157956466,22956466,1.1700478962962964,2011,happy feet two2011
5573,like crazy,250000,3395391,3728400,3478400,14.9136,2011,like crazy2011
5705,absentia,70000,0,8555,-61445,0.12221428571428572,2011,absentia2011
5025,pom wonderful presents the greatest movie ever sold,1800000,638476,783733,-1016267,0.4354072222222222,2011,pom wonderful presents the greatest movie ever sold2011
251,the adventures of tintin,130000000,77591831,373993951,243993951,2.8768765461538464,2011,the adventures of tintin2011
1723,the tree of life,35000000,13305665,61721826,26721826,1.7634807428571428,2011,the tree of life2011
3966,albert nobbs,7500000,3014696,8539003,1039003,1.1385337333333334,2011,albert nobbs2011
5283,the perfect host,1000000,48764,51587,-948413,0.051587,2011,the perfect host2011
2478,the beaver,21000000,970816,5046038,-15953962,0.2402875238095238,2011,the beaver2011
5421,the harvestla cosecha,560000,3709,3709,-556291,0.006623214285714286,2011,the harvestla cosecha2011
169,thor,150000000,181030624,449326618,299326618,2.995510786666667,2011,thor2011
1695,abduction,35000000,28087155,86648359,51648359,2.4756674,2011,abduction2011
173,kung fu panda 2,150000000,165249063,664837547,514837547,4.432250313333333,2011,kung fu panda 22011
5340,circumstance,900000,454121,958978,58978,1.0655311111111112,2011,circumstance2011
2357,i dont know how she does it,24000000,9659074,24474463,474463,1.0197692916666667,2011,i dont know how she does it2011
5143,forget me not,1300000,0,13465,-1286535,0.010357692307692307,2011,forget me not2011
2623,whats your number,20000000,14011084,30163785,10163785,1.50818925,2011,whats your number2011
133,cowboys and aliens,163000000,100368560,176038324,13038324,1.079989717791411,2011,cowboys and aliens2011
3789,glee the 3d concert movie,9000000,11862398,17462398,8462398,1.9402664444444444,2011,glee the 3d concert movie2011
1599,the rite,37000000,33047633,97143987,60143987,2.625513162162162,2011,the rite2011
63,transformers dark of the moon,195000000,352390543,1123790543,928790543,5.763028425641026,2011,transformers dark of the moon2011
3984,3,7200000,59774,295492,-6904508,0.04104055555555555,2011,32011
5617,the grace card,200000,2430735,2430735,2230735,12.153675,2011,the grace card2011
2747,take me home tonight,19000000,6928068,7576604,-11423396,0.3987686315789474,2011,take me home tonight2011
2306,carnage,25000000,2546747,38112154,13112154,1.52448616,2011,carnage2011
228,rango,135000000,123477607,245724600,110724600,1.8201822222222221,2011,rango2011
5261,the future,1000000,568662,1239174,239174,1.239174,2011,the future2011
1,pirates of the caribbean on stranger tides,410600000,241063875,1045663875,635063875,2.546672856794934,2011,pirates of the caribbean on stranger tides2011
3981,die welle,7250000,0,35122948,27872948,4.844544551724138,2011,die welle2011
2668,a dangerous method,20000000,5702083,14807531,-5192469,0.74037655,2011,a dangerous method2011
1654,friends with benefits,35000000,55802754,146595891,111595891,4.188454028571429,2011,friends with benefits2011
1315,the rum diary,45000000,13109815,21544732,-23455268,0.4787718222222222,2011,the rum diary2011
1605,gnomeo and juliet,36000000,99967670,193737977,157737977,5.381610472222222,2011,gnomeo and juliet2011
209,captain america the first avenger,140000000,176654505,370569776,230569776,2.6469269714285715,2011,captain america the first avenger2011
1448,final destination 5,40000000,42587643,155011165,115011165,3.875279125,2011,final destination 52011
2752,george balanchines the nutcracker,19000000,2119994,2119994,-16880006,0.11157863157894737,2011,george balanchines the nutcracker2011
4349,everything must go,5000000,2712131,2821010,-2178990,0.564202,2011,everything must go2011
2583,monte carlo,20000000,23186769,39686769,19686769,1.98433845,2011,monte carlo2011
4636,margin call,3400000,5353586,20433227,17033227,6.009772647058823,2011,margin call2011
4551,another happy day,4000000,9120,978527,-3021473,0.24463175,2011,another happy day2011
4053,hesher,7000000,382946,382946,-6617054,0.05470657142857143,2011,hesher2011
4546,stake land,4000000,33245,679482,-3320518,0.1698705,2011,stake land2011
2782,soul surfer,18000000,43853424,47158652,29158652,2.6199251111111113,2011,soul surfer2011
4439,salvando al soldado perez,4500000,1400726,9330465,4830465,2.073436666666667,2011,salvando al soldado perez2011
4441,nannerl la soeur de mozart,4500000,707885,2404639,-2095361,0.5343642222222222,2011,nannerl la soeur de mozart2011
3247,justin bieber never say never,13000000,73013910,99034125,86034125,7.618009615384615,2011,justin bieber never say never2011
1179,dream house,50000000,21302340,41642166,-8357834,0.83284332,2011,dream house2011
711,war horse,70000000,79883359,156815529,86815529,2.2402218428571428,2011,war horse2011
737,killer elite,70000000,25124986,65409046,-4590954,0.9344149428571429,2011,killer elite2011
4200,winter in wartime,5800000,542860,9662214,3862214,1.6658989655172414,2011,winter in wartime2011
1938,winnie the pooh,30000000,26692846,50145607,20145607,1.6715202333333334,2011,winnie the pooh2011
610,jack and jill,79000000,74158157,150519217,71519217,1.9053065443037975,2011,jack and jill2011
1071,the changeup,52000000,37243418,75997067,23997067,1.4614820576923078,2011,the changeup2011
4194,the hit list,6000000,0,0,-6000000,0.0,2011,the hit list2011
4293,apollo 18,5000000,17686929,26517819,21517819,5.3035638,2011,apollo 182011
4193,freaky deaky,6000000,0,0,-6000000,0.0,2011,freaky deaky2011
4192,a shine of rainbows,6000000,0,0,-6000000,0.0,2011,a shine of rainbows2011
2162,the help,25000000,169705587,213120004,188120004,8.52480016,2011,the help2011
5647,another earth,175000,1321194,2102779,1927779,12.01588,2011,another earth2011
2933,the artist,16000000,44667095,128256712,112256712,8.0160445,2011,the artist2011
644,immortals,75000000,83504017,211562435,136562435,2.820832466666667,2011,immortals2011
4179,akmareul boatda,6000000,129210,13168809,7168809,2.1948015,2011,akmareul boatda2011
2938,the roommate,16000000,37300107,52545707,36545707,3.2841066875,2011,the roommate2011
1080,the adjustment bureau,50200000,62495645,126931325,76731325,2.5285124501992033,2011,the adjustment bureau2011
4175,the 5th quarter,6000000,408159,408159,-5591841,0.0680265,2011,the 5th quarter2011
513,arthur christmas,85000000,46462469,149717124,64717124,1.7613779294117646,2011,arthur christmas2011
2273,warrior,25000000,13657115,24215385,-784615,0.9686154,2011,warrior2011
2779,diary of a wimpy kid rodrick rules,18000000,52698535,73695194,55695194,4.094177444444444,2011,diary of a wimpy kid rodrick rules2011
4420,le nom des gens,4600000,514237,9261711,4661711,2.0134154347826088,2011,le nom des gens2011
756,hall pass,68000000,45060734,87173475,19173475,1.281962867647059,2011,hall pass2011
1113,we bought a zoo,50000000,75624550,118729073,68729073,2.37458146,2011,we bought a zoo2011
4408,take shelter,4750000,1728953,4972016,222016,1.0467402105263157,2011,take shelter2011
1882,midnight in paris,30000000,56816662,162502774,132502774,5.416759133333334,2011,midnight in paris2011
2089,anonymous,27500000,4463292,15815509,-11684491,0.5751094181818182,2011,anonymous2011
2191,madeas big happy family,25000000,53345287,54160818,29160818,2.16643272,2011,madeas big happy family2011
4413,without men,4700000,0,0,-4700000,0.0,2011,without men2011
870,contagion,60000000,75658097,137551594,77551594,2.2925265666666665,2011,contagion2011
2279,the conspirator,25000000,11538204,15907411,-9092589,0.63629644,2011,the conspirator2011
4521,red state,4000000,1065429,1983596,-2016404,0.495899,2011,red state2011
2287,straw dogs,25000000,10324441,11253821,-13746179,0.45015284,2011,straw dogs2011
4519,the art of getting by,4000000,1430241,1989035,-2010965,0.49725875,2011,the art of getting by2011
2059,30 minutes or less,28000000,37053924,40966716,12966716,1.463097,2011,30 minutes or less2011
4975,grave encounters,2000000,0,2151887,151887,1.0759435,2011,grave encounters2011
4172,jãsannin no shikaku,6000000,802778,18727440,12727440,3.12124,2011,jãsannin no shikaku2011
4996,true bromance,2000000,0,0,-2000000,0.0,2011,true bromance2011
1263,the muppets,45000000,88625922,160971922,115971922,3.5771538222222223,2011,the muppets2011
4472,cargo,4200000,0,313230,-3886770,0.07457857142857142,2011,cargo2011
2471,tinker tailor soldier spy,21000000,24149393,81452811,60452811,3.8787052857142856,2011,tinker tailor soldier spy2011
3035,drive,15000000,35060689,81357930,66357930,5.423862,2011,drive2011
826,hop,63000000,108085305,188657593,125657593,2.994564968253968,2011,hop2011
61,green lantern,200000000,116601172,219535492,19535492,1.09767746,2011,green lantern2011
3240,the last godfather,13400000,164247,164247,-13235753,0.012257238805970148,2011,the last godfather2011
4445,blackthorn,4500000,200558,1217307,-3282693,0.2705126666666667,2011,blackthorn2011
4040,the mighty macs,7000000,1891936,1891936,-5108064,0.2702765714285714,2011,the mighty macs2011
1190,drive angry,50000000,10721033,41042583,-8957417,0.82085166,2011,drive angry2011
4571,down for life,3800000,41914,41914,-3758086,0.01103,2011,down for life2011
4939,meeks cutoff,2000000,977772,1869928,-130072,0.934964,2011,meeks cutoff2011
430,rise of the planet of the apes,93000000,176760185,470986200,377986200,5.064367741935484,2011,rise of the planet of the apes2011
5008,submarine,1900000,467602,4581937,2681937,2.411545789473684,2011,submarine2011
661,sucker punch,75000000,36392502,89758389,14758389,1.19677852,2011,sucker punch2011
445,rio,90000000,143619809,487519809,397519809,5.416886766666667,2011,rio2011
1944,sanctum,30000000,23209310,108957098,78957098,3.631903266666667,2011,sanctum2011
3083,one day,15000000,13843771,59168692,44168692,3.9445794666666667,2011,one day2011
476,the three musketeers,90000000,20377913,139877913,49877913,1.5541990333333333,2011,the three musketeers2011
4103,tracker,6500000,0,3149,-6496851,0.0004844615384615385,2011,tracker2011
2002,xinhai geming,30000000,135739,8593154,-21406846,0.28643846666666667,2011,xinhai geming2011
724,the dilemma,70000000,48475290,70546865,546865,1.0078123571428572,2011,the dilemma2011
3226,margaret,14000000,47185,623292,-13376708,0.04452085714285714,2011,margaret2011
4096,shame,6500000,4002293,20412841,13912841,3.1404370769230767,2011,shame2011
2251,shark night 3d,25000000,18877153,18877153,-6122847,0.75508612,2011,shark night 3d2011
2099,spy kids all the time in the world,27000000,38536376,80681183,53681183,2.9881919629629627,2011,spy kids all the time in the world2011
450,the girl with the dragon tattoo,90000000,102515793,239373970,149373970,2.6597107777777778,2011,the girl with the dragon tattoo2011
1177,your highness,50000000,21596445,26121638,-23878362,0.52243276,2011,your highness2011
2090,limitless,27000000,79249455,155564919,128564919,5.761663666666666,2011,limitless2011
1998,machine gun preacher,30000000,538690,3721988,-26278012,0.12406626666666666,2011,machine gun preacher2011
4616,trolljegeren,3500000,253444,5706638,2206638,1.630468,2011,trolljegeren2011
928,priest,60000000,29136626,84154026,24154026,1.4025671,2011,priest2011
1127,i am number four,50000000,55100437,146195159,96195159,2.92390318,2011,i am number four2011
1924,larry crowne,30000000,35608245,61449135,31449135,2.0483045,2011,larry crowne2011
2130,new yearâs eve,26000000,54544638,146850273,120850273,5.648087423076923,2011,new yearâs eve2011
4153,the guard,6000000,5359774,21197454,15197454,3.532909,2011,the guard2011
1978,hoodwinked too hood vs evil,30000000,10143779,23353111,-6646889,0.7784370333333334,2011,hoodwinked too hood vs evil2011
4342,des hommes et des dieux,5000000,3954651,46263525,41263525,9.252705,2011,des hommes et des dieux2011
4851,go for it,2450000,180237,182358,-2267642,0.07443183673469388,2011,go for it2011
2231,the sitter,25000000,30542576,38749404,13749404,1.54997616,2011,the sitter2011
1633,horrible bosses,35000000,117538559,212417601,177417601,6.069074314285714,2011,horrible bosses2011
1092,super 8,50000000,127004179,257972745,207972745,5.1594549,2011,super 82011
1107,crazy stupid love,50000000,84351197,147142328,97142328,2.94284656,2011,crazy stupid love2011
1913,hanna,30000000,40259119,65343694,35343694,2.1781231333333335,2011,hanna2011
3167,elle sappelait sarah,14500000,7691700,25480031,10980031,1.7572435172413794,2011,elle sappelait sarah2011
4627,213,3500000,0,0,-3500000,0.0,2011,2132011
4368,tucker  dale vs evil,5000000,223838,5476793,476793,1.0953586,2011,tucker  dale vs evil2011
504,tower heist,85000000,78046570,150422946,65422946,1.7696817176470587,2011,tower heist2011
2249,the eagle,25000000,19490041,38993548,13993548,1.55974192,2011,the eagle2011
56,cars 2,200000000,191450875,560155383,360155383,2.800776915,2011,cars 22011
4809,fat sick  nearly dead,2600000,0,0,-2600000,0.0,2011,fat sick  nearly dead2011
4250,paranormal activity 3,5000000,104028807,207039844,202039844,41.4079688,2011,paranormal activity 32011
570,zookeeper,80000000,80360866,170805525,90805525,2.1350690625,2011,zookeeper2011
5642,weekend,190000,484592,1577585,1387585,8.303078947368421,2011,weekend2011
2886,beastly,17000000,27865571,38028230,21028230,2.236954705882353,2011,beastly2011
4245,dum maaro dum,5200000,564489,11633427,6433427,2.2371975,2011,dum maaro dum2011
1008,mr popperss penguins,55000000,68224452,189624452,134624452,3.4477173090909092,2011,mr popperss penguins2011
4753,tanner hall,3000000,5073,5073,-2994927,0.001691,2011,tanner hall2011
557,just go with it,80000000,103028109,214974953,134974953,2.6871869125,2011,just go with it2011
4169,snow flower and the secret fan,6000000,1348205,11348205,5348205,1.8913675,2011,snow flower and the secret fan2011
3150,the son of no one,15000000,30680,1148578,-13851422,0.07657186666666667,2011,the son of no one2011
4737,creature,3000000,331000,331000,-2669000,0.11033333333333334,2011,creature2011
4763,never back down 2 the beatdown,3000000,0,0,-3000000,0.0,2011,never back down 2 the beatdown2011
4228,le havre,5500000,611709,13480196,7980196,2.450944727272727,2011,le havre2011
4886,courageous,2000000,34522221,35185884,33185884,17.592942,2011,courageous2011
4230,salvation boulevard,5500000,28468,28468,-5471532,0.005176,2011,salvation boulevard2011
4624,the kick,3500000,0,40622,-3459378,0.011606285714285715,2011,the kick2011
4656,beginners,3200000,5790894,14314407,11114407,4.4732521875,2011,beginners2011
4833,super,2500000,327716,593933,-1906067,0.2375732,2011,super2011
4394,we have your husband,5000000,0,0,-5000000,0.0,2011,we have your husband2011
1957,fright night,30000000,18298649,40520649,10520649,1.3506883,2011,fright night2011
4806,la cara oculta,2600000,0,7033931,4433931,2.7053580769230767,2011,la cara oculta2011
2183,no strings attached,25000000,70662220,149228078,124228078,5.96912312,2011,no strings attached2011
4277,our idiot brother,5000000,24814830,25861249,20861249,5.1722498,2011,our idiot brother2011
548,alvin and the chipmunks chipwrecked,80000000,133107389,349088523,269088523,4.3636065375,2011,alvin and the chipmunks chipwrecked2011
4227,haevnen,5500000,1008098,15867314,10367314,2.8849661818181818,2011,haevnen2011
4732,hobo with a shotgun,3000000,703372,834953,-2165047,0.2783176666666667,2011,hobo with a shotgun2011
538,the hangover part ii,80000000,254464305,586464305,506464305,7.3308038125,2011,the hangover part ii2011
4147,bernie,6000000,9204489,10106975,4106975,1.6844958333333333,2012,bernie2012
4145,the words,6000000,11494838,16369708,10369708,2.7282846666666667,2012,the words2012
3189,the iron lady,14000000,29959436,115592104,101592104,8.256578857142857,2012,the iron lady2012
506,mirror mirror,85000000,64935167,173613482,88613482,2.0425115529411766,2012,mirror mirror2012
1773,step up revolution,33000000,35074677,165552290,132552290,5.0167360606060605,2012,step up revolution2012
5171,blue like jazz,1200000,595018,595018,-604982,0.49584833333333334,2012,blue like jazz2012
274,prometheus,125000000,126477084,402448265,277448265,3.21958612,2012,prometheus2012
5182,below zero,1200000,0,0,-1200000,0.0,2012,below zero2012
275,the bourne legacy,125000000,113203870,280355920,155355920,2.24284736,2012,the bourne legacy2012
1910,the cabin in the woods,30000000,42073277,70689968,40689968,2.3563322666666666,2012,the cabin in the woods2012
287,life of pi,120000000,124987022,620912003,500912003,5.174266691666666,2012,life of pi2012
5175,pink ribbons inc,1200000,26608,26608,-1173392,0.022173333333333333,2012,pink ribbons inc2012
2317,les petits mouchoirs,25000000,205505,48530887,23530887,1.94123548,2012,les petits mouchoirs2012
1343,21 jump street,42000000,138447667,202812429,160812429,4.828867357142857,2012,21 jump street2012
3235,seven psychopaths,13500000,15024049,33035736,19535736,2.4470915555555557,2012,seven psychopaths2012
362,cloud atlas,102000000,27108272,130673154,28673154,1.2811093529411766,2012,cloud atlas2012
368,django unchained,100000000,162805434,449948323,349948323,4.49948323,2012,django unchained2012
405,jin lãng shã san chai,100000000,311434,98227017,-1772983,0.98227017,2012,jin lãng shã san chai2012
4987,the legend of hellâs gate an american conspiracy,2000000,0,0,-2000000,0.0,2012,the legend of hellâs gate an american conspiracy2012
4988,highway,2000000,0,0,-2000000,0.0,2012,highway2012
380,the expendables 2,100000000,85028192,311979256,211979256,3.11979256,2012,the expendables 22012
5030,dysfunctional friends,1800000,0,0,-1800000,0.0,2012,dysfunctional friends2012
5183,crowsnest,1200000,0,0,-1200000,0.0,2012,crowsnest2012
1822,flight,31000000,93772375,160558438,129558438,5.179304451612904,2012,flight2012
3276,the perks of being a wallflower,13000000,17742948,33069303,20069303,2.5437925384615383,2012,the perks of being a wallflower2012
498,safe house,85000000,126181630,208542162,123542162,2.4534372,2012,safe house2012
2748,wont back down,19000000,5310554,5745503,-13254497,0.3023948947368421,2012,wont back down2012
3336,the paperboy,12500000,677200,4027663,-8472337,0.32221304,2012,the paperboy2012
3344,think like a man,12000000,91547205,113373764,101373764,9.447813666666667,2012,think like a man2012
917,trouble with the curve,60000000,35763137,47818913,-12181087,0.7969818833333333,2012,trouble with the curve2012
1253,taken 2,45000000,139854287,377807404,332807404,8.395720088888888,2012,taken 22012
718,underworld awakening,70000000,62321039,160379930,90379930,2.2911418571428572,2012,underworld awakening2012
2621,lockout,20000000,14326865,33943049,13943049,1.69715245,2012,lockout2012
5472,enter nowhere,500000,0,0,-500000,0.0,2012,enter nowhere2012
5017,beasts of the southern wild,1800000,12795746,23265132,21465132,12.925073333333334,2012,beasts of the southern wild2012
5667,sound of my voice,135000,408015,429448,294448,3.181096296296296,2012,sound of my voice2012
5280,hardflip,1000000,96734,96734,-903266,0.096734,2012,hardflip2012
1903,the three stooges,30000000,44338224,54052249,24052249,1.8017416333333334,2012,the three stooges2012
1777,safe,33000000,17142080,41495213,8495213,1.257430696969697,2012,safe2012
3750,amour,9700000,6738954,36787044,27087044,3.792478762886598,2012,amour2012
5609,burn,225000,1109276,1109276,884276,4.930115555555555,2012,burn2012
3209,fun size,14000000,9409538,11166615,-2833385,0.7976153571428571,2012,fun size2012
31,battleship,220000000,65233400,313477717,93477717,1.4248987136363636,2012,battleship2012
30,the amazing spiderman,220000000,262030663,757890267,537890267,3.444955759090909,2012,the amazing spiderman2012
4882,infected,2100000,0,0,-2100000,0.0,2012,infected2012
2719,de rouille et dâos,19500000,2061449,29393634,9893634,1.5073658461538462,2012,de rouille et dâos2012
4896,silent house,2000000,12739737,16610760,14610760,8.30538,2012,silent house2012
1363,man on a ledge,42000000,18620000,49621440,7621440,1.1814628571428571,2012,man on a ledge2012
2458,silver linings playbook,21000000,132092958,236412453,215412453,11.257735857142857,2012,silver linings playbook2012
1358,one for the money,42000000,26414527,36197221,-5802779,0.8618385952380953,2012,one for the money2012
1787,wanderlust,32500000,17288155,24159934,-8340066,0.7433825846153846,2012,wanderlust2012
495,hotel transylvania,85000000,148313048,378505812,293505812,4.453009552941176,2012,hotel transylvania2012
1351,here comes the boom,42000000,45290318,73239258,31239258,1.7437918571428572,2012,here comes the boom2012
1125,american reunion,50000000,56758835,236799211,186799211,4.73598422,2012,american reunion2012
4152,casa de mi padre,6000000,5909483,8446952,2446952,1.4078253333333333,2012,casa de mi padre2012
3987,magic mike,7000000,113721571,170549753,163549753,24.364250428571427,2012,magic mike2012
1752,stolen,35000000,289773,17967746,-17032254,0.5133641714285714,2012,stolen2012
1287,savages,45000000,47323100,82513490,37513490,1.833633111111111,2012,savages2012
3180,the possession,14000000,49130588,82925064,68925064,5.9232188571428575,2012,the possession2012
1033,the pirates band of misfits,55000000,31051126,136143605,81143605,2.4753382727272726,2012,the pirates band of misfits2012
3357,project x,12000000,54731865,103028188,91028188,8.585682333333333,2012,project x2012
2855,red lights,17700000,49521,14518884,-3181116,0.8202759322033898,2012,red lights2012
2707,zambezia,20000000,0,34454336,14454336,1.7227168,2012,zambezia2012
1435,the odd life of timothy green,40000000,51853450,55249159,15249159,1.381228975,2012,the odd life of timothy green2012
537,the hunger games,80000000,408010692,677923379,597923379,8.4740422375,2012,the hunger games2012
224,the twilight saga breaking dawn part 2,136200000,292324737,829724737,693524737,6.0919584214390605,2012,the twilight saga breaking dawn part 22012
5217,chernobyl diaries,1000000,18119640,42411721,41411721,42.411721,2012,chernobyl diaries2012
1083,ted,50000000,218665740,556016627,506016627,11.12033254,2012,ted2012
1936,the fiveyear engagement,30000000,28700285,61623819,31623819,2.0541273,2012,the fiveyear engagement2012
4182,deadfall,6000000,66351,1673635,-4326365,0.2789391666666667,2012,deadfall2012
4211,khiladi 786,5600000,385422,14683763,9083763,2.622100535714286,2012,khiladi 7862012
3378,katy perry part of me,12000000,25326071,32700439,20700439,2.7250365833333334,2012,katy perry part of me2012
2513,tyler perrys madeas witness protection,20000000,65653242,66950887,46950887,3.34754435,2012,tyler perrys madeas witness protection2012
2690,the oogieloves in the big balloon adventure,20000000,1065907,1065907,-18934093,0.05329535,2012,the oogieloves in the big balloon adventure2012
3763,jab tak hai jaan,9200000,3047539,5806666,-3393334,0.631159347826087,2012,jab tak hai jaan2012
4825,robot  frank,2500000,3317468,4934356,2434356,1.9737424,2012,robot  frank2012
3823,polisse,8900000,176988,22744132,13844132,2.5555204494382022,2012,polisse2012
3354,chronicle,12000000,64575175,123681790,111681790,10.306815833333333,2012,chronicle2012
5234,october baby,1000000,5355847,5391992,4391992,5.391992,2012,october baby2012
5195,serbuan maut,1100000,4105123,9297407,8197407,8.452188181818181,2012,serbuan maut2012
4812,2016 obamaâs america,2500000,33349941,33349941,30849941,13.3399764,2012,2016 obamaâs america2012
5211,the devil inside,1000000,53262945,101759490,100759490,101.75949,2012,the devil inside2012
1065,zero dark thirty,52500000,95720716,134612435,82112435,2.564046380952381,2012,zero dark thirty2012
5427,high road,546173,0,0,-546173,0.0,2012,high road2012
3185,tyler perrys good deeds,14000000,35025791,35579177,21579177,2.5413697857142856,2012,tyler perrys good deeds2012
1841,the vow,30000000,125014030,197618160,167618160,6.587272,2012,the vow2012
4205,the inbetweeners,5700000,35955,86051320,80351320,15.096722807017544,2012,the inbetweeners2012
4202,trade of innocents,5800000,15091,15091,-5784909,0.002601896551724138,2012,trade of innocents2012
5622,middle of nowhere,200000,236806,236806,36806,1.18403,2012,middle of nowhere2012
4973,the ghastly love of johnny x,2000000,2436,2436,-1997564,0.001218,2012,the ghastly love of johnny x2012
1212,anna karenina,49000000,12816367,71004627,22004627,1.4490740204081634,2012,anna karenina2012
1314,dredd,45000000,13414714,41467606,-3532394,0.9215023555555556,2012,dredd2012
5732,foreign letters,40000,0,0,-40000,0.0,2012,foreign letters2012
1326,argo,44500000,136025503,227140757,182640757,5.104286674157303,2012,argo2012
1325,foodfight,45000000,0,73706,-44926294,0.0016379111111111111,2012,foodfight2012
4072,house at the end of the street,6900000,31611916,44103982,37203982,6.391881449275362,2012,house at the end of the street2012
2457,to rome with love,21500000,16684352,74326015,52826015,3.457023953488372,2012,to rome with love2012
1874,hope springs,30000000,63536011,133085295,103085295,4.4361765,2012,hope springs2012
3929,wuthering heights,8000000,100915,2721534,-5278466,0.34019175,2012,wuthering heights2012
3351,act of valor,12000000,70012847,82497035,70497035,6.874752916666667,2012,act of valor2012
5232,the sessions,1000000,6002451,11495204,10495204,11.495204,2012,the sessions2012
3311,womb,13000000,0,0,-13000000,0.0,2012,womb2012
413,ice age continental drift,95000000,161321843,879765137,784765137,9.26068565263158,2012,ice age continental drift2012
4966,the first time,2000000,17061,17061,-1982939,0.0085305,2012,the first time2012
2276,cirque du soleil worlds away,25000000,12512862,28012862,3012862,1.12051448,2012,cirque du soleil worlds away2012
1868,looper,30000000,66486205,170466405,140466405,5.6822135,2012,looper2012
4042,we need to talk about kevin,7000000,1738692,10765283,3765283,1.5378975714285714,2012,we need to talk about kevin2012
5712,hayride,60000,0,0,-60000,0.0,2012,hayride2012
417,the campaign,95000000,86907746,104907746,9907746,1.1042920631578947,2012,the campaign2012
5184,airborne,1200000,0,0,-1200000,0.0,2012,airborne2012
3338,a little bit of heaven,12500000,10011,1100287,-11399713,0.08802296,2012,a little bit of heaven2012
5199,beyond the black rainbow,1100000,56491,56491,-1043509,0.051355454545454544,2012,beyond the black rainbow2012
2874,pitch perfect,17000000,65001093,116044347,99044347,6.826138058823529,2012,pitch perfect2012
18,the hobbit an unexpected journey,250000000,303003568,1017003568,767003568,4.068014272,2012,the hobbit an unexpected journey2012
5711,the fp,60000,0,0,-60000,0.0,2012,the fp2012
3081,killing them softly,15000000,14945541,39238443,24238443,2.6158962,2012,killing them softly2012
728,rock of ages,70000000,38518613,61031932,-8968068,0.8718847428571429,2012,rock of ages2012
3078,the man with the iron fists,15000000,15634090,22018988,7018988,1.4679325333333333,2012,the man with the iron fists2012
5330,trance,950000,0,0,-950000,0.0,2012,trance2012
5333,lfe happens,930000,30905,30905,-899095,0.03323118279569892,2012,lfe happens2012
2666,chasing mavericks,20000000,6002756,8300821,-11699179,0.41504105,2012,chasing mavericks2012
4730,damsels in distress,3000000,1007535,1324299,-1675701,0.441433,2012,damsels in distress2012
196,madagascar 3 europes most wanted,145000000,216391482,746921271,601921271,5.151181179310345,2012,madagascar 3 europes most wanted2012
1709,premium rush,35000000,20275446,31393201,-3606799,0.8969486,2012,premium rush2012
3698,coriolanus,10000000,749641,2179623,-7820377,0.2179623,2012,coriolanus2012
201,rise of the guardians,145000000,103412758,306900902,161900902,2.116557944827586,2012,rise of the guardians2012
2194,the grey,25000000,51580136,81249176,56249176,3.24996704,2012,the grey2012
609,journey 2 the mysterious island,79000000,103860290,318146162,239146162,4.027166607594936,2012,journey 2 the mysterious island2012
4734,bachelorette,3000000,446770,12577401,9577401,4.192467,2012,bachelorette2012
2144,the raven,26000000,16008272,30601801,4601801,1.176992346153846,2012,the raven2012
4239,hodejegerne,5250000,1200010,20188740,14938740,3.845474285714286,2012,hodejegerne2012
2137,lawless,26000000,37397291,54393687,28393687,2.0920648846153846,2012,lawless2012
3554,the best exotic marigold hotel,10000000,46383639,134639780,124639780,13.463978,2012,the best exotic marigold hotel2012
772,lincoln,65000000,182207973,273346281,208346281,4.2053274,2012,lincoln2012
888,paranorman,60000000,56003051,108119662,48119662,1.8019943666666667,2012,paranorman2012
118,snow white and the huntsman,170000000,155136755,401021746,231021746,2.3589514470588235,2012,snow white and the huntsman2012
4555,a lonely place to die,4000000,0,442550,-3557450,0.1106375,2012,a lonely place to die2012
4557,the loved ones,4000000,0,12302,-3987698,0.0030755,2012,the loved ones2012
764,abraham lincoln vampire hunter,67500000,37519139,137489730,69989730,2.036884888888889,2012,abraham lincoln vampire hunter2012
777,les miserables,65000000,148809770,442169052,377169052,6.8026008,2012,les miserables2012
5672,your sisters sister,120000,1597486,3090593,2970593,25.754941666666667,2012,your sisters sister2012
4562,the helpers,4000000,0,0,-4000000,0.0,2012,the helpers2012
4565,how to fall in love,4000000,0,0,-4000000,0.0,2012,how to fall in love2012
5311,truth or die,1000000,0,0,-1000000,0.0,2012,truth or die2012
762,doctor seuss the lorax,67500000,214030500,350976753,283476753,5.1996556,2012,doctor seuss the lorax2012
617,astãrix et obãlix au service de sa majestã,77600000,0,60680125,-16919875,0.7819603737113402,2012,astãrix et obãlix au service de sa majestã2012
1458,the guilt trip,40000000,37134215,41294674,1294674,1.03236685,2012,the guilt trip2012
1547,frankenweenie,39000000,35287788,81150788,42150788,2.0807894358974357,2012,frankenweenie2012
972,ghost rider spirit of vengeance,57000000,51774002,149217355,92217355,2.6178483333333333,2012,ghost rider spirit of vengeance2012
3744,detention,10000000,0,0,-10000000,0.0,2012,detention2012
5342,the giant mechanical man,900000,7396,7396,-892604,0.008217777777777777,2012,the giant mechanical man2012
970,thats my boy,57500000,36931089,58085235,585235,1.010178,2012,thats my boy2012
2932,moonrise kingdom,16000000,45512466,68848446,52848446,4.303027875,2012,moonrise kingdom2012
5353,celeste and jesse forever,840000,3103407,3787689,2947689,4.5091535714285715,2012,celeste and jesse forever2012
960,red tails,58000000,49876377,50365498,-7634502,0.8683706551724137,2012,red tails2012
1026,the watch,55000000,34353000,67130045,12130045,1.2205462727272727,2012,the watch2012
5347,for a good time call,850000,1251749,1386088,536088,1.6306917647058823,2012,for a good time call2012
5691,indie game the movie,100000,0,0,-100000,0.0,2012,indie game the movie2012
5351,snitch,850000,0,0,-850000,0.0,2012,snitch2012
3689,killer joe,10000000,1291645,4659110,-5340890,0.465911,2012,killer joe2012
3714,high school,10000000,139034,248133,-9751867,0.0248133,2012,high school2012
1699,alex cross,35000000,25888412,35426759,426759,1.0121931142857143,2012,alex cross2012
2677,the cold light of day,20000000,3763583,25361206,5361206,1.2680603,2012,the cold light of day2012
2903,the apparition,17000000,4936819,10637281,-6362719,0.6257224117647059,2012,the apparition2012
4743,tim and erics billion dollar movie,3000000,201436,223652,-2776348,0.07455066666666667,2012,tim and erics billion dollar movie2012
2178,parental guidance,25000000,77267296,120832383,95832383,4.83329532,2012,parental guidance2012
3413,for greater glory the true story of cristiada,12000000,5669081,10026255,-1973745,0.83552125,2012,for greater glory the true story of cristiada2012
3408,arbitrage,12000000,7919574,35830713,23830713,2.98589275,2012,arbitrage2012
2184,contraband,25000000,66528000,98406855,73406855,3.9362742,2012,contraband2012
34,men in black 3,215000000,179020854,654213485,439213485,3.042853418604651,2012,men in black 32012
2186,the lucky one,25000000,60457138,96633833,71633833,3.86535332,2012,the lucky one2012
4752,the divide,3000000,18000,156362,-2843638,0.05212066666666667,2012,the divide2012
4258,paranormal activity 4,5000000,53900335,142817992,137817992,28.5635984,2012,paranormal activity 42012
4417,barfi,4600000,2804874,36751984,32151984,7.989561739130435,2012,barfi2012
5310,snow white a deadly summer,1000000,0,0,-1000000,0.0,2012,snow white a deadly summer2012
1586,the master,37500000,16247159,50647416,13147416,1.35059776,2012,the master2012
2959,people like us,16000000,12431792,12617472,-3382528,0.788592,2012,people like us2012
5376,safety not guaranteed,750000,4010957,4422318,3672318,5.896424,2012,safety not guaranteed2012
5595,the frozen,250000,0,0,-250000,0.0,2012,the frozen2012
1500,a thousand words,40000000,18450127,20790486,-19209514,0.51976215,2012,a thousand words2012
2381,kari gurashi no arietti,23000000,19192510,151496097,128496097,6.586786826086956,2012,kari gurashi no arietti2012
1499,the impossible,40000000,19019882,169590606,129590606,4.23976515,2012,the impossible2012
3664,jeff who lives at home,10000000,4269426,4708127,-5291873,0.4708127,2012,jeff who lives at home2012
5369,kill list,800000,29063,462206,-337794,0.5777575,2012,kill list2012
186,wrath of the titans,150000000,83670083,305270083,155270083,2.035133886666667,2012,wrath of the titans2012
1498,big miracle,40000000,20157300,25268680,-14731320,0.631717,2012,big miracle2012
4668,sinister,3000000,48086903,87727807,84727807,29.242602333333334,2012,sinister2012
188,dark shadows,150000000,79727149,238202668,88202668,1.5880177866666667,2012,dark shadows2012
5377,the innkeepers,750000,78396,1011535,261535,1.3487133333333334,2012,the innkeepers2012
13,john carter,275000000,73058679,282778100,7778100,1.028284,2012,john carter2012
5401,after,650000,0,0,-650000,0.0,2012,after2012
2978,vamps,16000000,3361,94812,-15905188,0.00592575,2012,vamps2012
10,the dark knight rises,275000000,448139099,1084439099,809439099,3.9434149054545453,2012,the dark knight rises2012
2416,diary of a wimpy kid dog days,22000000,49008662,77229695,55229695,3.510440681818182,2012,diary of a wimpy kid dog days2012
2604,silent hill revelation 3d,20000000,17530219,55975672,35975672,2.7987836,2012,silent hill revelation 3d2012
2085,joyful noise,27500000,30932113,31157914,3657914,1.1330150545454545,2012,joyful noise2012
4395,shouldve been romeo,5000000,0,0,-5000000,0.0,2012,shouldve been romeo2012
5452,the other dream team,500000,134109,314444,-185556,0.628888,2012,the other dream team2012
3595,sparkle,10000000,24397469,24660323,14660323,2.4660323,2012,sparkle2012
4381,mientras duermes,5000000,0,9109597,4109597,1.8219194,2012,mientras duermes2012
130,wreckit ralph,165000000,189412677,496511521,331511521,3.0091607333333332,2012,wreckit ralph2012
51,skyfall,200000000,304360277,1110526981,910526981,5.552634905,2012,skyfall2012
2382,haywire,23000000,18942396,36374700,13374700,1.581508695652174,2012,haywire2012
3651,the collection,10000000,6810754,8890094,-1109906,0.8890094,2012,the collection2012
3670,atlas shrugged part ii,10000000,3336053,3336053,-6663947,0.3336053,2012,atlas shrugged part ii2012
4561,replicas,4000000,0,0,-4000000,0.0,2012,replicas2012
5481,el rey de najayo,500000,0,0,-500000,0.0,2012,el rey de najayo2012
3647,seeking a friend for the end of the world,10000000,7078738,11766959,1766959,1.1766959,2012,seeking a friend for the end of the world2012
5772,newlyweds,9000,4584,4584,-4416,0.5093333333333333,2012,newlyweds2012
795,the dictator,65000000,59650222,180148897,115148897,2.7715214923076923,2012,the dictator2012
4524,holy motors,4000000,641054,4230426,230426,1.0576065,2012,holy motors2012
3511,le prãnom,11000000,61611,25307405,14307405,2.300673181818182,2012,le prãnom2012
3028,end of watch,15000000,41003371,57586606,42586606,3.8391070666666667,2012,end of watch2012
3513,lol,11000000,0,10431506,-568494,0.9483187272727273,2012,lol2012
3517,les intouchables,10800000,13182281,484873045,474073045,44.89565231481482,2012,les intouchables2012
4467,snabba cash,4300000,188870,10212403,5912403,2.374977441860465,2012,snabba cash2012
1644,this is 40,35000000,67544505,90221182,55221182,2.5777480571428573,2012,this is 402012
5560,some guy who kills people,300000,0,0,-300000,0.0,2012,some guy who kills people2012
3017,the woman in black,15000000,54333290,128955898,113955898,8.597059866666667,2012,the woman in black2012
5567,compliance,270000,319285,830700,560700,3.0766666666666667,2012,compliance2012
803,resident evil retribution,65000000,42345531,240647629,175647629,3.7022712153846156,2012,resident evil retribution2012
4403,the awakening,4900000,95933,6924321,2024321,1.4131267346938776,2012,the awakening2012
867,jack reacher,60000000,80070736,217370736,157370736,3.6228456,2012,jack reacher2012
3433,darling companion,12000000,793352,1200346,-10799654,0.10002883333333333,2012,darling companion2012
1585,what to expect when youre expecting,37500000,41152203,88473016,50973016,2.3592804266666665,2012,what to expect when youre expecting2012
797,this means war,65000000,54760791,156974557,91974557,2.4149931846153847,2012,this means war2012
2436,hit  run,22000000,13749300,17216955,-4783045,0.7825888636363636,2012,hit  run2012
5473,girls gone dead,500000,0,0,-500000,0.0,2012,girls gone dead2012
800,red dawn,65000000,44806783,48164150,-16835850,0.740986923076923,2012,red dawn2012
5552,nothing but a man,300000,17241,17241,-282759,0.05747,2012,nothing but a man2012
4517,samsara,4000000,2672413,5966671,1966671,1.49166775,2012,samsara2012
76,brave,185000000,237282182,554606532,369606532,2.997873145945946,2012,brave2012
1427,escape from planet earth,40000000,57012977,74156610,34156610,1.85391525,2013,escape from planet earth2013
925,the mortal instruments city of bones,60000000,31165421,75965567,15965567,1.2660927833333333,2013,the mortal instruments city of bones2013
1710,broken city,35000000,19701164,34480045,-519955,0.9851441428571429,2013,broken city2013
2010,space pirate captain harlock,30000000,0,310985,-29689015,0.010366166666666666,2013,space pirate captain harlock2013
1717,parker,35000000,17616641,48543388,13543388,1.386953942857143,2013,parker2013
4407,only god forgives,4800000,775849,4494560,-305440,0.9363666666666667,2013,only god forgives2013
3066,the place beyond the pines,15000000,21403519,47011449,32011449,3.1340966,2013,the place beyond the pines2013
3394,about time,12000000,15323921,89309178,77309178,7.4424315,2013,about time2013
3390,nebraska,12000000,17654912,24761360,12761360,2.0634466666666667,2013,nebraska2013
5726,a true story,45000,0,0,-45000,0.0,2013,a true story2013
3758,rekill,9500000,0,0,-9500000,0.0,2013,rekill2013
3364,philomena,12000000,37709979,98963392,86963392,8.246949333333333,2013,philomena2013
1952,runner runner,30000000,19316646,60512680,30512680,2.0170893333333333,2013,runner runner2013
5741,paraphobia,30000,0,0,-30000,0.0,2013,paraphobia2013
3822,a haunting in connecticut 2 the ghosts of georgia,9000000,0,0,-9000000,0.0,2013,a haunting in connecticut 2 the ghosts of georgia2013
20,the hobbit the desolation of smaug,250000000,258366855,960366855,710366855,3.84146742,2013,the hobbit the desolation of smaug2013
4363,aint them bodies saints,5000000,391611,1075009,-3924991,0.2150018,2013,aint them bodies saints2013
1734,mandela long walk to freedom,35000000,8323085,29890402,-5109598,0.8540114857142858,2013,mandela long walk to freedom2013
1806,the incredible burt wonderstone,32000000,22537881,27392609,-4607391,0.85601903125,2013,the incredible burt wonderstone2013
3275,admission,13000000,18007317,18733666,5733666,1.4410512307692307,2013,admission2013
3269,21 and over,13000000,25682380,42195766,29195766,3.245828153846154,2013,21 and over2013
1103,disney planes,50000000,90282580,238059569,188059569,4.76119138,2013,disney planes2013
4272,dallas buyers club,5000000,27298285,60611845,55611845,12.122369,2013,dallas buyers club2013
1091,anchorman 2 the legend continues,50000000,127352707,172185754,122185754,3.44371508,2013,anchorman 2 the legend continues2013
3837,baggage claim,8500000,21569509,22885836,14385836,2.6924512941176473,2013,baggage claim2013
3802,the sapphires,9000000,2450867,20395040,11395040,2.2661155555555554,2013,the sapphires2013
3853,yeh jawaani hai deewani,8300000,3827466,50827466,42527466,6.123791084337349,2013,yeh jawaani hai deewani2013
307,the wolverine,115000000,132556852,416456852,301456852,3.6213639304347827,2013,the wolverine2013
5728,this is martin bonner,42000,0,0,-42000,0.0,2013,this is martin bonner2013
4217,don jon,5500000,24477704,41268579,35768579,7.503378,2013,don jon2013
71,pacific rim,190000000,101802906,411002906,221002906,2.1631731894736843,2013,pacific rim2013
52,monsters university,200000000,268488329,743588329,543588329,3.717941645,2013,monsters university2013
155,frozen,150000000,400738009,1272469910,1122469910,8.483132733333333,2013,frozen2013
5124,eddie the sleepwalking cannibal,1400000,1632,1632,-1398368,0.0011657142857142858,2013,eddie the sleepwalking cannibal2013
315,gravity,110000000,274092705,693698673,583698673,6.306351572727273,2013,gravity2013
592,walking with dinosaurs,80000000,36076121,123368842,43368842,1.542110525,2013,walking with dinosaurs2013
4821,the spectacular now,2500000,6852971,6916951,4416951,2.7667804,2013,the spectacular now2013
436,the secret life of walter mitty,91000000,58236838,187861183,96861183,2.0644086043956045,2013,the secret life of walter mitty2013
5012,stranded,1900000,0,285593,-1614407,0.15031210526315789,2013,stranded2013
1631,identity thief,35000000,134506920,175361578,140361578,5.0103308,2013,identity thief2013
1821,42,31000000,95020213,97470701,66470701,3.1442161612903226,2013,422013
3337,ernest et celestine,12500000,292562,9376444,-3123556,0.75011552,2013,ernest et celestine2013
1383,lone survivor,40000000,125095601,149804632,109804632,3.7451158,2013,lone survivor2013
3887,enough said,8000000,17550872,25621449,17621449,3.202681125,2013,enough said2013
1786,the big wedding,32500000,21819348,48425971,15925971,1.4900298769230769,2013,the big wedding2013
1790,this is the end,32000000,101470202,126539117,94539117,3.95434740625,2013,this is the end2013
5734,her cry la llorona investigation,35000,0,0,-35000,0.0,2013,her cry la llorona investigation2013
1977,dead man down,30000000,10895295,19599974,-10400026,0.6533324666666667,2013,dead man down2013
1334,the heat,43000000,159581587,229727774,186727774,5.342506372093023,2013,the heat2013
3911,le passã,8000000,1335672,15752575,7752575,1.969071875,2013,le passã2013
3112,promised land,15000000,7597898,12394562,-2605438,0.8263041333333333,2013,promised land2013
1973,the last stand,30000000,12050299,48330757,18330757,1.6110252333333333,2013,the last stand2013
3313,the call,12800000,51872378,69821476,57021476,5.4548028125,2013,the call2013
2517,12 years a slave,20000000,56671993,181025343,161025343,9.05126715,2013,12 years a slave2013
3937,feichang xingyun,8000000,0,21970000,13970000,2.74625,2013,feichang xingyun2013
1379,american hustle,40000000,150117807,257878294,217878294,6.44695735,2013,american hustle2013
3141,the reluctant fundamentalist,15000000,528731,528731,-14471269,0.03524873333333333,2013,the reluctant fundamentalist2013
3524,the last days on mars,10600000,24084,261364,-10338636,0.02465698113207547,2013,the last days on mars2013
1015,free birds,55000000,55750480,110387072,55387072,2.0070376727272725,2013,free birds2013
12,the lone ranger,275000000,89302115,260002115,-14997885,0.9454622363636364,2013,the lone ranger2013
5755,all superheroes must die,20000,0,0,-20000,0.0,2013,all superheroes must die2013
1589,were the millers,37000000,150394119,267816276,230816276,7.23827772972973,2013,were the millers2013
2492,the conjuring,20000000,137400141,318000141,298000141,15.90000705,2013,the conjuring2013
3452,supesu batorushippu yamato,12000000,0,0,-12000000,0.0,2013,supesu batorushippu yamato2013
2040,safe haven,28000000,71399120,94050951,66050951,3.358962535714286,2013,safe haven2013
3680,the iceman,10000000,1930282,3623609,-6376391,0.3623609,2013,the iceman2013
1565,riddick,38000000,42025135,94763758,56763758,2.493783105263158,2013,riddick2013
3638,movie 43,10000000,8840453,31164747,21164747,3.1164747,2013,movie 432013
1537,un monstre ã paris,40000000,0,27000381,-12999619,0.675009525,2013,un monstre ã paris2013
3489,quartet,11000000,18388357,56178935,45178935,5.107175909090909,2013,quartet2013
1570,rush,38000000,26947624,98230839,60230839,2.5850220789473686,2013,rush2013
4454,hansel  gretel get baked,4500000,0,0,-4500000,0.0,2013,hansel  gretel get baked2013
1552,yi dai zong shi,38600000,6594959,57987299,19387299,1.5022616321243523,2013,yi dai zong shi2013
1476,grudge match,40000000,29807260,69807260,29807260,1.7451815,2013,grudge match2013
1518,paranoia,40000000,7388654,16340767,-23659233,0.408519175,2013,paranoia2013
3493,inside llewyn davis,11000000,13248209,32943247,21943247,2.9948406363636364,2013,inside llewyn davis2013
3428,stoker,12000000,1703125,12034913,34913,1.0029094166666668,2013,stoker2013
3699,parkland,10000000,641439,1616353,-8383647,0.1616353,2013,parkland2013
3597,mud,10000000,21590086,31556959,21556959,3.1556959,2013,mud2013
3497,peeples,11000000,9177065,9307166,-1692834,0.846106,2013,peeples2013
3422,la grande bellezza,12000000,2883879,29549145,17549145,2.46242875,2013,la grande bellezza2013
1636,saving mr banks,35000000,83299761,114962525,79962525,3.2846435714285716,2013,saving mr banks2013
4452,the sweeney,4500000,26345,8000366,3500366,1.777859111111111,2013,the sweeney2013
2810,jobs,18000000,16131410,43402515,25402515,2.4112508333333333,2013,jobs2013
3587,one direction this is us,10000000,28873374,68541786,58541786,6.8541786,2013,one direction this is us2013
3842,all is lost,8500000,6263670,10386814,1886814,1.2219781176470588,2013,all is lost2013
903,gangster squad,60000000,46000903,104100903,44100903,1.73501505,2013,gangster squad2013
4302,spring breakers,5000000,14124286,31149251,26149251,6.2298502,2013,spring breakers2013
3153,khumba,15000000,0,20898221,5898221,1.3932147333333333,2013,khumba2013
4252,insidious chapter 2,5000000,83586447,161921515,156921515,32.384303,2013,insidious chapter 22013
4235,tao jie,5400000,0,4728896,-671104,0.8757214814814814,2013,tao jie2013
3149,winnie mandela,15000000,61847,61847,-14938153,0.004123133333333333,2013,winnie mandela2013
4237,grabbers,5300000,0,440821,-4859179,0.08317377358490566,2013,grabbers2013
4238,la vie dadãle â chapitres 1  2,5250000,2450504,22914479,17664479,4.364662666666667,2013,la vie dadãle â chapitres 1  22013
1041,bullet to the head,55000000,9489829,22597969,-32402031,0.41087216363636364,2013,bullet to the head2013
3710,cinco de mayo la batalla,10000000,173472,173472,-9826528,0.0173472,2013,cinco de mayo la batalla2013
991,captain phillips,55000000,107136417,220648184,165648184,4.011785163636364,2013,captain phillips2013
4282,the way way back,5000000,21502690,26853810,21853810,5.370762,2013,the way way back2013
1844,lee daniels the butler,30000000,116632095,177025498,147025498,5.900849933333333,2013,lee daniels the butler2013
1247,prisoners,46000000,61002302,113402302,67402302,2.465267434782609,2013,prisoners2013
4261,no se aceptan devoluciones,5000000,44467206,100486616,95486616,20.0973232,2013,no se aceptan devoluciones2013
962,the internship,58000000,44672764,93672764,35672764,1.6150476551724138,2013,the internship2013
5714,the dirties,55000,0,0,-55000,0.0,2013,the dirties2013
4044,the christmas candle,7000000,1632000,1933829,-5066171,0.2762612857142857,2013,the christmas candle2013
1203,upside down,50000000,102118,26387039,-23612961,0.52774078,2013,upside down2013
1921,the family,30000000,36918811,51078541,21078541,1.7026180333333334,2013,the family2013
1869,warm bodies,30000000,66380662,115121608,85121608,3.8373869333333332,2013,warm bodies2013
5710,supporting characters,60000,4917,4917,-55083,0.08195,2013,supporting characters2013
4065,twixt,7000000,0,1268346,-5731654,0.18119228571428572,2013,twixt2013
1184,beautiful creatures,50000000,19452138,60282876,10282876,1.20565752,2013,beautiful creatures2013
28,man of steel,225000000,291045518,667999518,442999518,2.9688867466666666,2013,man of steel2013
1167,the host,50000000,26623701,64477051,14477051,1.28954102,2013,the host2013
4098,the east,6500000,2274649,3027956,-3472044,0.4658393846153846,2013,the east2013
1126,hansel  gretel witch hunters,50000000,55703475,214949716,164949716,4.29899432,2013,hansel  gretel witch hunters2013
1242,mr nobody,46500000,3622,22254,-46477746,0.0004785806451612903,2013,mr nobody2013
2721,the frozen ground,19200000,0,5617460,-13582540,0.2925760416666667,2013,the frozen ground2013
356,the hangover 3,103000000,112200072,362000072,259000072,3.514563805825243,2013,the hangover 32013
5337,fruitvale station,900000,16098998,17549645,16649645,19.499605555555554,2013,fruitvale station2013
2560,scary movie v,20000000,32015787,78613981,58613981,3.93069905,2013,scary movie v2013
47,iron man 3,200000000,408992272,1215392272,1015392272,6.07696136,2013,iron man 32013
5010,abcd any body can dance,1900000,222098,10137234,8237234,5.335386315789473,2013,abcd any body can dance2013
2045,last vegas,28000000,63914167,112914167,84914167,4.032648821428571,2013,last vegas2013
2440,out of the furnace,22000000,11330849,15434375,-6565625,0.7015625,2013,out of the furnace2013
4489,the last exorcism part ii,4000000,15179303,25448707,21448707,6.36217675,2013,the last exorcism part ii2013
838,2 guns,61000000,75612460,132493015,71493015,2.172016639344262,2013,2 guns2013
212,gi joe retaliation,140000000,122523060,375740705,235740705,2.6838621785714287,2013,gi joe retaliation2013
4990,coffee town,2000000,0,0,-2000000,0.0,2013,coffee town2013
4989,small apartments,2000000,0,0,-2000000,0.0,2013,small apartments2013
5299,heli,1000000,0,552614,-447386,0.552614,2013,heli2013
2862,black nativity,17500000,7018188,7285135,-10214865,0.4162934285714286,2013,black nativity2013
2575,the worlds end,20000000,26004851,47508505,27508505,2.37542525,2013,the worlds end2013
2428,homefront,22000000,20158492,51695362,29695362,2.3497891818181817,2013,homefront2013
4972,plush,2000000,3080,28864,-1971136,0.014432,2013,plush2013
230,turbo,135000000,83028130,286896578,151896578,2.125159837037037,2013,turbo2013
2214,august osage county,25000000,37738810,50738810,25738810,2.0295524,2013,august osage county2013
4978,stitches,2000000,0,63555,-1936445,0.0317775,2013,stitches2013
225,the croods,135000000,187168425,573068425,438068425,4.244951296296296,2013,the croods2013
547,grown ups 2,80000000,133668525,247023808,167023808,3.0877976,2013,grown ups 22013
375,the wolf of wall street,100000000,116900694,389870414,289870414,3.89870414,2013,the wolf of wall street2013
4765,30 nights of paranormal activity with the devil inside the girl with the dragon tattoo,3000000,0,0,-3000000,0.0,2013,30 nights of paranormal activity with the devil inside the girl with the dragon tattoo2013
376,epic,100000000,107518682,262794441,162794441,2.62794441,2013,epic2013
5042,grace unplugged,1700000,2507159,2507159,807159,1.4747994117647059,2013,grace unplugged2013
4986,straight as,2000000,0,0,-2000000,0.0,2013,straight as2013
2064,kickass 2,28000000,28795985,63129909,35129909,2.254639607142857,2013,kickass 22013
2872,the best man holiday,17000000,70525195,72835710,55835710,4.284453529411764,2013,the best man holiday2013
2876,evil dead,17000000,54239856,97778356,80778356,5.751668,2013,evil dead2013
5561,midnight cabaret,300000,0,0,-300000,0.0,2013,midnight cabaret2013
5216,youre next,1000000,18494006,26887177,25887177,26.887177,2013,youre next2013
5312,black rock,1000000,0,0,-1000000,0.0,2013,black rock2013
5583,the canyons,250000,59671,62375,-187625,0.2495,2013,the canyons2013
237,the hunger games catching fire,130000000,424668047,864868047,734868047,6.652831130769231,2013,the hunger games catching fire2013
2836,metallica through the never,18000000,3419967,9082906,-8917094,0.5046058888888889,2013,metallica through the never2013
67,star trek into darkness,190000000,228778661,467381584,277381584,2.4599030736842105,2013,star trek into darkness2013
4554,geograf globus propil,4000000,0,4454853,454853,1.11371325,2013,geograf globus propil2013
433,a good day to die hard,92000000,67349198,304249198,212249198,3.3070565,2013,a good day to die hard2013
332,the smurfs 2,110000000,71017784,348547523,238547523,3.1686138454545456,2013,the smurfs 22013
5314,my last day without you,1000000,0,0,-1000000,0.0,2013,my last day without you2013
5483,bucky and the squirrels,500000,0,0,-500000,0.0,2013,bucky and the squirrels2013
5077,the gatekeepers,1500000,2408553,2592308,1092308,1.7282053333333334,2013,the gatekeepers2013
5076,the to do list,1500000,3491669,4128828,2628828,2.752552,2013,the to do list2013
4552,inescapable,4000000,4327,4327,-3995673,0.00108175,2013,inescapable2013
2789,blue jasmine,18000000,33404871,102912961,84912961,5.717386722222222,2013,blue jasmine2013
68,world war z,190000000,202359711,531514650,341514650,2.7974455263157894,2013,world war z2013
111,47 ronin,175000000,38362475,151716815,-23283185,0.8669532285714285,2013,47 ronin2013
2740,the book thief,19000000,21488481,76086711,57086711,4.004563736842106,2013,the book thief2013
4811,a haunted house,2500000,40041683,59922558,57422558,23.9690232,2013,a haunted house2013
65,jack the giant slayer,195000000,65187603,197687603,2687603,1.0137825794871795,2013,jack the giant slayer2013
335,enders game,110000000,61737191,127983283,17983283,1.1634843909090908,2013,enders game2013
5663,aroused,150000,0,0,-150000,0.0,2013,aroused2013
2554,texas chainsaw 3d,20000000,34341945,47666013,27666013,2.38330065,2013,texas chainsaw 3d2013
3008,mama,15000000,71628180,148095566,133095566,9.873037733333334,2013,mama2013
5031,independence daysaster,1800000,0,0,-1800000,0.0,2013,independence daysaster2013
2192,tyler perrys a madea christmas,25000000,52543354,52543354,27543354,2.10173416,2013,tyler perrys a madea christmas2013
4758,open road,3000000,0,47469,-2952531,0.015823,2013,open road2013
5265,the act of killing,1000000,486919,1227316,227316,1.227316,2013,the act of killing2013
5083,the lords of salem,1500000,1165881,1541131,41131,1.0274206666666668,2013,the lords of salem2013
2132,pain  gain,26000000,49875291,81275291,55275291,3.125972730769231,2013,pain  gain2013
4698,before midnight,3000000,8110621,23251930,20251930,7.7506433333333336,2013,before midnight2013
4666,the purge,3000000,64473115,91266581,88266581,30.422193666666665,2013,the purge2013
5404,treachery,625000,0,0,-625000,0.0,2013,treachery2013
165,thor the dark world,150000000,206362140,644602516,494602516,4.297350106666666,2013,thor the dark world2013
4713,frances ha,3000000,4067398,11262769,8262769,3.754256333333333,2013,frances ha2013
527,red 2,84000000,53262560,141507355,57507355,1.684611369047619,2013,red 22013
4596,dark skies,3500000,17418667,27704111,24204111,7.9154602857142855,2013,dark skies2013
736,escape plan,70000000,25135965,103735965,33735965,1.4819423571428572,2013,escape plan2013
5451,deceptive practice the mysteries and mentors of ricky jay,500000,152449,152449,-347551,0.304898,2013,deceptive practice the mysteries and mentors of ricky jay2013
139,fast and furious 6,160000000,238679850,789300444,629300444,4.933127775,2013,fast and furious 62013
5315,zombie hunter,1000000,0,0,-1000000,0.0,2013,zombie hunter2013
5465,detention of the dead,500000,1778,1778,-498222,0.003556,2013,detention of the dead2013
5236,20 feet from stardom,1000000,4946250,5892466,4892466,5.892466,2013,20 feet from stardom2013
2257,the counselor,25000000,16973715,71009334,46009334,2.84037336,2013,the counselor2013
5468,now is good,500000,0,2141436,1641436,4.282872,2013,now is good2013
2420,delivery man,22000000,30659817,70536870,48536870,3.2062213636363635,2013,delivery man2013
4813,kevin hart let me explain,2500000,32244051,32327255,29827255,12.930902,2013,kevin hart let me explain2013
2650,battle of the year,20000000,8888355,16723377,-3276623,0.83616885,2013,battle of the year2013
463,percy jackson sea of monsters,90000000,68559554,200859554,110859554,2.231772822222222,2013,percy jackson sea of monsters2013
5444,drinking buddies,500000,343706,407100,-92900,0.8142,2013,drinking buddies2013
2981,zulu,16000000,0,1844228,-14155772,0.11526425,2013,zulu2013
252,after earth,130000000,60522097,251499665,121499665,1.9346128076923077,2013,after earth2013
2396,redemption,23000000,36686,13593473,-9406527,0.5910205652173913,2013,redemption2013
5661,speak no evil,150000,0,32927,-117073,0.21951333333333334,2013,speak no evil2013
2842,phantom,18000000,1034589,1199510,-16800490,0.06663944444444445,2013,phantom2013
2657,machete kills,20000000,8008161,18273009,-1726991,0.91365045,2013,machete kills2013
2316,on the road,25000000,720828,9313302,-15686698,0.37253208,2013,on the road2013
5382,all the boys love mandy lane,750000,0,1960521,1210521,2.614028,2013,all the boys love mandy lane2013
3002,jackass presents bad grandpa,15000000,102003019,160903019,145903019,10.726867933333333,2013,jackass presents bad grandpa2013
4662,antiviral,3100000,0,123407,-2976593,0.039808709677419354,2013,antiviral2013
5343,the brass teapot,900000,6997,413733,-486267,0.45970333333333335,2013,the brass teapot2013
2451,metegol,22000000,0,34061097,12061097,1.5482316818181818,2013,metegol2013
291,elysium,120000000,93050117,286192091,166192091,2.3849340916666666,2013,elysium2013
292,oblivion,120000000,89107235,287916633,167916633,2.399305275,2013,oblivion2013
5207,the vatican exorcisms,1100000,0,0,-1100000,0.0,2013,the vatican exorcisms2013
621,despicable me 2,76000000,368065385,975216835,899216835,12.831800460526315,2013,despicable me 22013
5151,filly brown,1250000,2850357,2940411,1690411,2.3523288,2013,filly brown2013
2819,getaway,18000000,10501938,11813989,-6186011,0.6563327222222223,2013,getaway2013
4632,jagten,3450000,687185,18309793,14859793,5.307186376811594,2013,jagten2013
254,ripd,130000000,33618855,79076678,-50923322,0.6082821384615384,2013,ripd2013
5399,escape from tomorrow,650000,171962,171962,-478038,0.2645569230769231,2013,escape from tomorrow2013
4628,batman the dark knight returns part 2,3500000,0,0,-3500000,0.0,2013,batman the dark knight returns part 22013
189,white house down,150000000,73103784,205440387,55440387,1.36960258,2013,white house down2013
612,cloudy with a chance of meatballs 2,78000000,119793567,274392649,196392649,3.517854474358974,2013,cloudy with a chance of meatballs 22013
2359,dhoom 3,24000000,8031955,11723620,-12276380,0.48848416666666666,2013,dhoom 32013
5165,home run,1200000,2859955,2859955,1659955,2.3832958333333334,2013,home run2013
4843,alien uprising,2500000,0,0,-2500000,0.0,2013,alien uprising2013
5187,the wicked within,1200000,0,0,-1200000,0.0,2013,the wicked within2013
2149,the fifth estate,26000000,3254172,6154172,-19845828,0.23669892307692308,2013,the fifth estate2013
708,olympus has fallen,70000000,98927592,172878928,102878928,2.4696989714285715,2013,olympus has fallen2013
4840,underdogs,2500000,35017,1392649,-1107351,0.5570596,2013,underdogs2013
53,oz the great and powerful,200000000,234770996,490359051,290359051,2.451795255,2013,oz the great and powerful2013
4830,the lost medallion the adventures of billy stone,2500000,549632,549632,-1950368,0.2198528,2013,the lost medallion the adventures of billy stone2013
640,now you see me,75000000,117723989,342769200,267769200,4.570256,2013,now you see me2013
5648,sparrows dance,175000,2602,2602,-172398,0.014868571428571429,2013,sparrows dance2013
567,fury,80000000,85817906,210315681,130315681,2.6289460125,2014,fury2014
3846,the rover,8500000,1109199,3180252,-5319748,0.3741472941176471,2014,the rover2014
5150,dear white people,1250000,4404154,5403771,4153771,4.3230168,2014,dear white people2014
1400,dumb and dumber to,40000000,86208010,156553592,116553592,3.9138398,2014,dumb and dumber to2014
3345,heaven is for real,12000000,91386097,100916299,88916299,8.409691583333334,2014,heaven is for real2014
1401,the other woman,40000000,83911193,195111193,155111193,4.877779825,2014,the other woman2014
4727,tusk,3000000,1821983,1887554,-1112446,0.6291846666666666,2014,tusk2014
1767,thunder and the house of magic,34000000,4091,62582520,28582520,1.8406623529411765,2014,thunder and the house of magic2014
3643,bad words,10000000,7779614,7843145,-2156855,0.7843145,2014,bad words2014
2713,dwegons and leprechauns,20000000,0,0,-20000000,0.0,2014,dwegons and leprechauns2014
3342,the fault in our stars,12000000,124872350,307166834,295166834,25.597236166666665,2014,the fault in our stars2014
3833,nightcrawler,8500000,32381218,50334418,41834418,5.921696235294117,2014,nightcrawler2014
5753,dry spell,22000,0,0,-22000,0.0,2014,dry spell2014
5141,los insolitos peces gato,1300000,11278,54665,-1245335,0.04205,2014,los insolitos peces gato2014
4359,atlas shrugged who is john galt,5000000,851690,851690,-4148310,0.170338,2014,atlas shrugged who is john galt2014
1382,lucy,40000000,126573960,457507776,417507776,11.4376944,2014,lucy2014
5402,the hadza last of the first,650000,0,0,-650000,0.0,2014,the hadza last of the first2014
5127,house at the end of the drive,1400000,0,0,-1400000,0.0,2014,house at the end of the drive2014
5126,kurmanjan datka,1400000,0,0,-1400000,0.0,2014,kurmanjan datka2014
3877,that awkward moment,8000000,26068955,53068955,45068955,6.633619375,2014,that awkward moment2014
2502,tammy,20000000,84525432,96407655,76407655,4.82038275,2014,tammy2014
1019,muppets most wanted,55000000,51178893,79312301,24312301,1.4420418363636363,2014,muppets most wanted2014
4484,boyhood,4000000,25379975,57273049,53273049,14.31826225,2014,boyhood2014
956,american sniper,58000000,350126372,547326372,489326372,9.436661586206897,2014,american sniper2014
4455,fugly,4500000,0,0,-4500000,0.0,2014,fugly2014
4283,as above so below,5000000,21222315,41824066,36824066,8.3648132,2014,as above so below2014
5122,la chambre bleue,1400000,260441,1945420,545420,1.3895857142857142,2014,la chambre bleue2014
1526,snowpiercer,40000000,4563029,88069880,48069880,2.201747,2014,snowpiercer2014
5112,once upon a time in queens,1500000,0,0,-1500000,0.0,2014,once upon a time in queens2014
5596,jesus people,250000,0,0,-250000,0.0,2014,jesus people2014
5109,closer to the moon,1500000,0,5396,-1494604,0.0035973333333333335,2014,closer to the moon2014
942,winterâs tale,60000000,12600231,29575033,-30424967,0.49291721666666666,2014,winterâs tale2014
215,exodus gods and kings,140000000,65014513,268314513,128314513,1.9165322357142858,2014,exodus gods and kings2014
2335,think like a man too,24000000,65028687,70027933,46027933,2.9178305416666666,2014,think like a man too2014
5270,antarctica a year on ice,1000000,288757,288757,-711243,0.288757,2014,antarctica a year on ice2014
5383,destiny,750000,0,450,-749550,0.0006,2014,destiny2014
261,the hunger games mockingjay  part 1,125000000,337135885,766575131,641575131,6.132601048,2014,the hunger games mockingjay  part 12014
5189,godâs not dead,1150000,60755732,63777092,62627092,55.45834086956522,2014,godâs not dead2014
5185,cotton comes to harlem,1200000,0,0,-1200000,0.0,2014,cotton comes to harlem2014
3453,drive hard,12000000,0,0,-12000000,0.0,2014,drive hard2014
3890,begin again,8000000,16170632,68838736,60838736,8.604842,2014,begin again2014
5106,housebound,1500000,0,236863,-1263137,0.15790866666666667,2014,housebound2014
5735,happy 40th,35000,0,0,-35000,0.0,2014,happy 40th2014
5411,water  power,600000,42557,42557,-557443,0.07092833333333333,2014,water  power2014
325,300 rise of an empire,110000000,106580051,330780051,220780051,3.0070913727272726,2014,300 rise of an empire2014
5417,the maids room,600000,0,0,-600000,0.0,2014,the maids room2014
5418,light from the darkroom,600000,0,0,-600000,0.0,2014,light from the darkroom2014
3622,big eyes,10000000,14482031,27317872,17317872,2.7317872,2014,big eyes2014
1540,dragon nest warriors dawn,40000000,0,734423,-39265577,0.018360575,2014,dragon nest warriors dawn2014
5426,faith connections,550000,9111,9111,-540889,0.016565454545454546,2014,faith connections2014
21,the hobbit the battle of the five armies,250000000,255119788,945577621,695577621,3.782310484,2014,the hobbit the battle of the five armies2014
1332,the interview,44000000,6105175,12342632,-31657368,0.2805143636363636,2014,the interview2014
3472,if i stay,11000000,50474843,78356170,67356170,7.1232881818181815,2014,if i stay2014
5331,jesse,950000,0,0,-950000,0.0,2014,jesse2014
5059,two night stand,1600000,15600,868081,-731919,0.542550625,2014,two night stand2014
5725,the image revolution,50000,0,0,-50000,0.0,2014,the image revolution2014
2410,son of god,22000000,59700064,70949793,48949793,3.224990590909091,2014,son of god2014
5041,the lunchbox,1700000,4231500,12231500,10531500,7.195,2014,the lunchbox2014
5032,against the wild,1800000,0,0,-1800000,0.0,2014,against the wild2014
4453,falcon rising,4500000,11774,11774,-4488226,0.0026164444444444442,2014,falcon rising2014
4757,they came together,3000000,0,82780,-2917220,0.027593333333333334,2014,they came together2014
4365,jimi all is by my side,5000000,340911,927074,-4072926,0.1854148,2014,jimi all is by my side2014
4629,in the name of the king iii,3500000,0,0,-3500000,0.0,2014,in the name of the king iii2014
2166,ride along,25000000,134202565,153733800,128733800,6.149352,2014,ride along2014
54,xmen days of future past,200000000,233921534,747862775,547862775,3.739313875,2014,xmen days of future past2014
720,dracula untold,70000000,55991880,220241723,150241723,3.1463103285714284,2014,dracula untold2014
3032,wild,15000000,37880356,52460543,37460543,3.4973695333333334,2014,wild2014
4550,13 sins,4000000,9134,47552,-3952448,0.011888,2014,13 sins2014
4377,rudderless,5000000,56001,567219,-4432781,0.1134438,2014,rudderless2014
4488,a haunted house 2,4000000,17329487,21206861,17206861,5.30171525,2014,a haunted house 22014
2151,blood ties,26000000,42472,2923959,-23076041,0.11245996153846154,2014,blood ties2014
3034,the theory of everything,15000000,35893537,123327692,108327692,8.221846133333333,2014,the theory of everything2014
4259,ouija,5000000,50856010,103300632,98300632,20.6601264,2014,ouija2014
4528,the face of love,4000000,385069,1158877,-2841123,0.28971925,2014,the face of love2014
4389,reach me,5000000,0,0,-5000000,0.0,2014,reach me2014
4384,dying of the light,5000000,0,74639,-4925361,0.0149278,2014,dying of the light2014
3049,when the game stands tall,15000000,30127963,30138912,15138912,2.0092608,2014,when the game stands tall2014
4319,momsâ night out,5000000,10429707,10537341,5537341,2.1074682,2014,momsâ night out2014
2141,the best of me,26000000,26766213,41059418,15059418,1.5792083846153846,2014,the best of me2014
745,legends of oz dorothyâs return,70000000,8462347,20107933,-49892067,0.28725618571428574,2014,legends of oz dorothyâs return2014
4769,iguana,3000000,0,0,-3000000,0.0,2014,iguana2014
4529,joe,4000000,373375,373375,-3626625,0.09334375,2014,joe2014
741,the legend of hercules,70000000,18848538,58953319,-11046681,0.8421902714285714,2014,the legend of hercules2014
4390,henry  me,5000000,0,0,-5000000,0.0,2014,henry  me2014
3075,a most wanted man,15000000,17237855,36068890,21068890,2.404592666666667,2014,a most wanted man2014
1453,sex tape,40000000,38543473,126069509,86069509,3.151737725,2014,sex tape2014
55,the amazing spiderman 2,200000000,202853933,708996336,508996336,3.54498168,2014,the amazing spiderman 22014
835,gone girl,61000000,167767189,368567189,307567189,6.042085065573771,2014,gone girl2014
4748,fort mccoy,3000000,78948,78948,-2921052,0.026316,2014,fort mccoy2014
2066,a walk among the tombstones,28000000,26017685,62108587,34108587,2.2181638214285715,2014,a walk among the tombstones2014
4630,wicked blood,3500000,0,0,-3500000,0.0,2014,wicked blood2014
815,sin city a dame to kill for,65000000,13757804,40650842,-24349158,0.6253975692307693,2014,sin city a dame to kill for2014
896,jack ryan shadow recruit,60000000,50577412,131377412,71377412,2.189623533333333,2014,jack ryan shadow recruit2014
5688,cheap thrills,100000,59424,59424,-40576,0.59424,2014,cheap thrills2014
4564,the perfect wave,4000000,0,0,-4000000,0.0,2014,the perfect wave2014
2043,alexander and the terrible horrible no good very bad day,28000000,66954149,101379287,73379287,3.6206888214285713,2014,alexander and the terrible horrible no good very bad day2014
2969,the homesman,16000000,2429989,8217571,-7782429,0.5135981875,2014,the homesman2014
995,the equalizer,55000000,101530738,192903624,137903624,3.507338618181818,2014,the equalizer2014
3060,the november man,15000000,25018119,34820335,19820335,2.321355666666667,2014,the november man2014
843,the lego movie,60000000,257784718,457729388,397729388,7.628823133333333,2014,the lego movie2014
2068,brick mansions,28000000,20396829,73421224,45421224,2.6221865714285713,2014,brick mansions2014
4271,oculus,5000000,27695246,44115496,39115496,8.8230992,2014,oculus2014
5689,the past is a grotesque animal,100000,20056,20056,-79944,0.20056,2014,the past is a grotesque animal2014
4269,paranormal activity the marked ones,5000000,32462372,90904854,85904854,18.1809708,2014,paranormal activity the marked ones2014
781,unbroken,65000000,115637895,163527824,98527824,2.515812676923077,2014,unbroken2014
596,pompeii,80000000,23169033,108469033,28469033,1.3558629125,2014,pompeii2014
713,the monuments men,70000000,78031620,158702748,88702748,2.2671821142857143,2014,the monuments men2014
5669,an american in hollywood,125000,0,0,-125000,0.0,2014,an american in hollywood2014
4642,whiplash,3300000,13092006,38969037,35669037,11.80879909090909,2014,whiplash2014
36,transformers age of extinction,210000000,245439076,1104039076,894039076,5.2573289333333335,2014,transformers age of extinction2014
4295,addicted,5000000,17390770,17499242,12499242,3.4998484,2014,addicted2014
2971,the immigrant,16000000,2013456,7585011,-8414989,0.4740631875,2014,the immigrant2014
2975,men women and children,16000000,705908,1685403,-14314597,0.1053376875,2014,men women and children2014
769,need for speed,66000000,43568507,194169619,128169619,2.9419639242424243,2014,need for speed2014
893,the boxtrolls,60000000,50837305,111946251,51946251,1.86577085,2014,the boxtrolls2014
2063,3 days to kill,28000000,30697999,38959900,10959900,1.391425,2014,3 days to kill2014
4350,kill the messenger,5000000,2450846,6656705,1656705,1.331341,2014,kill the messenger2014
3005,the imitation game,15000000,91125143,227740463,212740463,15.182697533333334,2014,the imitation game2014
813,i frankenstein,65000000,19075290,74575290,9575290,1.147312153846154,2014,i frankenstein2014
4463,anna,4357373,0,1200000,-3157373,0.2753952897766613,2014,anna2014
788,annie,65000000,85911262,139829625,74829625,2.151225,2014,annie2014
976,into the woods,56200000,128002372,213116401,156916401,3.7921067793594307,2014,into the woods2014
1728,sabotage,35000000,10508518,18376443,-16623557,0.5250412285714285,2014,sabotage2014
3315,the drop,12600000,10724389,19054534,6454534,1.5122646031746032,2014,the drop2014
5344,40 weeks,900000,0,0,-900000,0.0,2014,40 weeks2014
2412,the hundredfoot journey,22000000,54235441,94270488,72270488,4.2850221818181815,2014,the hundredfoot journey2014
3257,about last night,13000000,48637684,50445860,37445860,3.880450769230769,2014,about last night2014
5464,born to fly elizabeth streb vs gravity,500000,1822,1822,-498178,0.003644,2014,born to fly elizabeth streb vs gravity2014
5329,banshee chapter,950000,0,78122,-871878,0.08223368421052632,2014,banshee chapter2014
1140,the judge,50000000,47119388,76119388,26119388,1.52238776,2014,the judge2014
1084,22 jump street,50000000,191719337,331333876,281333876,6.62667752,2014,22 jump street2014
5522,pancakes,400000,0,0,-400000,0.0,2014,pancakes2014
1933,deliver us from evil,30000000,30577122,87956618,57956618,2.9318872666666667,2014,deliver us from evil2014
1934,get on up,30000000,30569935,33339868,3339868,1.1113289333333334,2014,get on up2014
2850,wolves,18000000,0,94953,-17905047,0.005275166666666667,2014,wolves2014
2852,the prince,18000000,0,0,-18000000,0.0,2014,the prince2014
5638,sanctuary quite a conundrum,200000,0,0,-200000,0.0,2014,sanctuary quite a conundrum2014
2216,million dollar arm,25000000,36447959,39217912,14217912,1.56871648,2014,million dollar arm2014
2556,this is where i leave you,20000000,34296320,41296320,21296320,2.064816,2014,this is where i leave you2014
4802,ida,2600000,3827060,15298355,12698355,5.8839826923076926,2014,ida2014
94,edge of tomorrow,178000000,100206256,370541256,192541256,2.081692449438202,2014,edge of tomorrow2014
5693,echo dr,100000,0,0,-100000,0.0,2014,echo dr2014
1611,dolphin tale 2,36000000,42024533,57824533,21824533,1.6062370277777778,2014,dolphin tale 22014
2868,letâs be cops,17000000,82390774,136890774,119890774,8.052398470588235,2014,letâs be cops2014
5641,h,200000,0,0,-200000,0.0,2014,h2014
3155,autã³mata,15000000,0,6775458,-8224542,0.4516972,2014,autã³mata2014
2201,the giver,25000000,45090374,66540205,41540205,2.6616082,2014,the giver2014
5556,locker 13,300000,3496,3496,-296504,0.011653333333333333,2014,locker 132014
5558,all you need is love,300000,0,3565259,3265259,11.884196666666666,2014,all you need is love2014
5692,dude wheres my dog,100000,0,0,-100000,0.0,2014,dude wheres my dog2014
83,maleficent,180000000,241407328,758536735,578536735,4.214092972222222,2014,maleficent2014
113,guardians of the galaxy,170000000,333172112,770867516,600867516,4.5345148,2014,guardians of the galaxy2014
4051,dom hemingway,7000000,523511,1857458,-5142542,0.26535114285714284,2014,dom hemingway2014
1826,the grand budapest hotel,31000000,59076019,163981261,132981261,5.289718096774194,2014,the grand budapest hotel2014
5475,america is still the place,500000,0,0,-500000,0.0,2014,america is still the place2014
4956,pump,2000000,72277,72277,-1927723,0.0361385,2014,pump2014
3745,nurse 3d,10000000,0,0,-10000000,0.0,2014,nurse 3d2014
4061,snezhnaya koroleva,7000000,0,15193977,8193977,2.170568142857143,2014,snezhnaya koroleva2014
4940,the babadook,2000000,950792,7482387,5482387,3.7411935,2014,the babadook2014
4936,locke,2000000,1370646,2088390,88390,1.044195,2014,locke2014
1871,the nut job,30000000,64251538,122529966,92529966,4.0843322,2014,the nut job2014
3241,under the skin,13300000,2614251,7229933,-6070067,0.543603984962406,2014,under the skin2014
5721,down and dangerous,50000,0,0,-50000,0.0,2014,down and dangerous2014
5499,as it is in heaven,450000,13486,13486,-436514,0.02996888888888889,2014,as it is in heaven2014
4083,annabelle,6500000,84273813,256862920,250362920,39.517372307692305,2014,annabelle2014
5632,the word,200000,3648,3648,-196352,0.01824,2014,the word2014
5500,mutual friends,450000,0,0,-450000,0.0,2014,mutual friends2014
4908,meet the mormons,2000000,6047363,6049171,4049171,3.0245855,2014,meet the mormons2014
5501,rise of the entrepreneur  the search for a better way,450000,0,0,-450000,0.0,2014,rise of the entrepreneur  the search for a better way2014
3217,mr turner,14000000,3958546,25187026,11187026,1.7990732857142857,2014,mr turner2014
128,big hero 6,165000000,222527828,652127828,487127828,3.952289866666667,2014,big hero 62014
131,interstellar,165000000,188017894,666379375,501379375,4.038662878787878,2014,interstellar2014
5479,diamond ruff,500000,0,0,-500000,0.0,2014,diamond ruff2014
5488,the sound and the shadow,500000,0,0,-500000,0.0,2014,the sound and the shadow2014
401,transcendence,100000000,23022309,103039258,3039258,1.03039258,2014,transcendence2014
4013,devils due,7000000,15821461,36146087,29146087,5.163726714285715,2014,devils due2014
5761,stories of our lives,15000,0,0,-15000,0.0,2014,stories of our lives2014
4015,beyond the lights,7000000,14618727,14618727,7618727,2.0883895714285714,2014,beyond the lights2014
4991,lucky dog,2000000,0,0,-2000000,0.0,2014,lucky dog2014
395,the expendables 3,100000000,39322544,209461378,109461378,2.09461378,2014,the expendables 32014
2785,birdman or the unexpected virtue of ignorance,18000000,42340598,103215094,85215094,5.734171888888889,2014,birdman or the unexpected virtue of ignorance2014
3260,st vincent,13000000,44137712,54837234,41837234,4.218248769230769,2014,st vincent2014
2763,neighbors,18000000,150086800,270944428,252944428,15.052468222222222,2014,neighbors2014
5588,test,250000,18823,18823,-231177,0.075292,2014,test2014
3243,no good deed,13200000,52543632,54323210,41123210,4.115394696969697,2014,no good deed2014
4160,wish i was here,6000000,3591299,6591365,591365,1.0985608333333334,2014,wish i was here2014
3261,earth to echo,13000000,38934842,42174545,29174545,3.2441957692307692,2014,earth to echo2014
1134,the book of life,50000000,50151543,97651543,47651543,1.95303086,2014,the book of life2014
1430,horrible bosses 2,40000000,54445357,105945357,65945357,2.648633925,2014,horrible bosses 22014
248,rio 2,130000000,131538435,492846291,362846291,3.7911253153846154,2014,rio 22014
250,noah,130000000,101200044,352831065,222831065,2.7140851153846155,2014,noah2014
5368,not cool,800000,35688,35688,-764312,0.04461,2014,not cool2014
5378,il conformista,750000,59656,89609,-660391,0.11947866666666666,2014,il conformista2014
2379,her,23000000,25568251,48163815,25163815,2.0940789130434783,2014,her2014
1759,the maze runner,34000000,102427862,348319861,314319861,10.244701794117647,2014,the maze runner2014
5201,the sleepwalker,1100000,2636,2636,-1097364,0.0023963636363636366,2014,the sleepwalker2014
3819,beneath hill 60,9000000,0,3440939,-5559061,0.38232655555555556,2014,beneath hill 602014
259,night at the museum secret of the tomb,127000000,113746621,353756621,226756621,2.7854852047244094,2014,night at the museum secret of the tomb2014
3673,rosewater,10000000,3128941,3185717,-6814283,0.3185717,2014,rosewater2014
5263,23 blast,1000000,549185,549185,-450815,0.549185,2014,23 blast2014
2655,inherent vice,20000000,8110975,14772346,-5227654,0.7386173,2014,inherent vice2014
5269,i origins,1000000,336472,852399,-147601,0.852399,2014,i origins2014
5320,bang bang baby,1000000,0,0,-1000000,0.0,2014,bang bang baby2014
5317,a fine step,1000000,0,0,-1000000,0.0,2014,a fine step2014
5316,doc hollidays revenge,1000000,0,0,-1000000,0.0,2014,doc hollidays revenge2014
5313,hidden away,1000000,0,0,-1000000,0.0,2014,hidden away2014
3723,elsa  fred,10000000,67657,197901,-9802099,0.0197901,2014,elsa  fred2014
198,how to train your dragon 2,145000000,177002924,614586270,469586270,4.238526,2014,how to train your dragon 22014
2667,a most violent year,20000000,5749134,8846875,-11153125,0.44234375,2014,a most violent year2014
200,mr peabody  sherman,145000000,111506430,269806430,124806430,1.860734,2014,mr peabody  sherman2014
3731,barbecue,10000000,388,247565,-9752435,0.0247565,2014,barbecue2014
3738,plastic,10000000,0,575371,-9424629,0.0575371,2014,plastic2014
3692,50 to 1,10000000,1069454,1069454,-8930546,0.1069454,2014,50 to 12014
1139,into the storm,50000000,47602194,150429371,100429371,3.00858742,2014,into the storm2014
5291,camp xray,1000000,9837,101053,-898947,0.101053,2014,camp xray2014
1447,a million ways to die in the west,40000000,42720965,86778557,46778557,2.169463925,2014,a million ways to die in the west2014
5235,the skeleton twins,1000000,5284309,5797192,4797192,5.797192,2014,the skeleton twins2014
5335,food chains,913000,0,176,-912824,0.0001927710843373494,2014,food chains2014
2328,the adventurer the curse of the midas box,25000000,0,0,-25000000,0.0,2014,the adventurer the curse of the midas box2014
1289,blended,45000000,46290741,127990741,82990741,2.844238688888889,2014,blended2014
5240,obvious child,1000000,3122616,3324070,2324070,3.32407,2014,obvious child2014
494,divergent,85000000,150947895,276014965,191014965,3.247234882352941,2014,divergent2014
5506,blue ruin,420000,258384,437002,17002,1.0404809523809524,2014,blue ruin2014
1123,planes fire and rescue,50000000,59157732,156399644,106399644,3.12799288,2014,planes fire and rescue2014
5637,archaeology of a woman,200000,0,0,-200000,0.0,2014,archaeology of a woman2014
1905,john wick,30000000,43037835,76235001,46235001,2.5411667,2014,john wick2014
5703,happy christmas,70000,30312,30312,-39688,0.43302857142857143,2014,happy christmas2014
2813,and so it goes,18000000,15160801,17920013,-79987,0.9955562777777778,2014,and so it goes2014
2235,draft day,25000000,28842237,29847480,4847480,1.1938992,2014,draft day2014
5587,nightlights,250000,21147,21147,-228853,0.084588,2014,nightlights2014
2581,endless love,20000000,23438250,34718173,14718173,1.73590865,2014,endless love2014
2448,before i go to sleep,22000000,3242457,19563579,-2436421,0.889253590909091,2014,before i go to sleep2014
4856,always woodstock,2400000,0,0,-2400000,0.0,2014,always woodstock2014
116,dawn of the planet of the apes,170000000,208545589,710644566,540644566,4.180262152941176,2014,dawn of the planet of the apes2014
4862,frontera,2300000,59696,59696,-2240304,0.025954782608695652,2014,frontera2014
1101,nonstop,50000000,91742160,222383055,172383055,4.4476611,2014,nonstop2014
236,penguins of madagascar,132000000,83350911,366942531,234942531,2.7798676590909093,2014,penguins of madagascar2014
2832,the railway man,18000000,4438438,23910210,5910210,1.328345,2014,the railway man2014
3379,top five,12000000,25317379,26001741,14001741,2.16681175,2014,top five2014
1442,jersey boys,40000000,47047013,65282732,25282732,1.6320683,2014,jersey boys2014
5257,palo alto,1000000,767732,1156309,156309,1.156309,2014,palo alto2014
5599,horse camp,250000,0,0,-250000,0.0,2014,horse camp2014
3770,the purge anarchy,9000000,71562550,111534881,102534881,12.392764555555555,2014,the purge anarchy2014
3941,swelter,8000000,0,44197,-7955803,0.005524625,2014,swelter2014
2818,labor day,18000000,13371528,14189810,-3810190,0.7883227777777778,2014,labor day2014
4162,veronica mars,6000000,3322127,3485383,-2514617,0.5808971666666667,2014,veronica mars2014
115,captain america the winter soldier,170000000,259746958,714401889,544401889,4.202364052941176,2014,captain america the winter soldier2014
4850,not safe for work,2500000,0,0,-2500000,0.0,2014,not safe for work2014
4255,the visit,5000000,65206105,98677816,93677816,19.7355632,2015,the visit2015
2205,the night before,25000000,43035725,52427346,27427346,2.09709384,2015,the night before2015
4794,sardaar ji,2700000,0,8200000,5500000,3.037037037037037,2015,sardaar ji2015
5565,amidst the devils wings,300000,0,0,-300000,0.0,2015,amidst the devils wings2015
4764,awol72,3000000,0,0,-3000000,0.0,2015,awol722015
3154,a few best men,15000000,0,17224539,2224539,1.1483026,2015,a few best men2015
5640,perfect cowboy,200000,0,0,-200000,0.0,2015,perfect cowboy2015
97,inside out,175000000,356461711,854235992,679235992,4.8813485257142855,2015,inside out2015
3156,chiamatemi francesco  il papa della gente,15000000,0,3925769,-11074231,0.2617179333333333,2015,chiamatemi francesco  il papa della gente2015
5563,walking to paris,300000,0,0,-300000,0.0,2015,walking to paris2015
4845,stung,2500000,0,0,-2500000,0.0,2015,stung2015
4847,8 days,2500000,0,0,-2500000,0.0,2015,8 days2015
5644,butterfly girl,180000,17503,17503,-162497,0.09723888888888889,2015,butterfly girl2015
5664,escaping the holocost,150000,0,0,-150000,0.0,2015,escaping the holocost2015
1891,southpaw,30000000,52421953,94156456,64156456,3.138548533333333,2015,southpaw2015
4893,it follows,2000000,14674077,23250755,21250755,11.6253775,2015,it follows2015
541,hotel transylvania 2,80000000,169700110,469500298,389500298,5.868753725,2015,hotel transylvania 22015
1032,crimson peak,55000000,31090320,74966854,19966854,1.363033709090909,2015,crimson peak2015
5562,teeth and blood,300000,0,0,-300000,0.0,2015,teeth and blood2015
4231,r100,5500000,24956,24956,-5475044,0.004537454545454545,2015,r1002015
33,jurassic world,215000000,652270625,1648854864,1433854864,7.669092390697674,2015,jurassic world2015
3,avengers age of ultron,330600000,459005868,1403013963,1072413963,4.243841388384755,2015,avengers age of ultron2015
2250,shaun the sheep,25000000,19375982,101925161,76925161,4.07700644,2015,shaun the sheep2015
4273,no escape,5000000,27288872,42844516,37844516,8.5689032,2015,no escape2015
5701,dawn of the crescent moon,75000,8799,8799,-66201,0.11732,2015,dawn of the crescent moon2015
5702,queen crab,75000,0,0,-75000,0.0,2015,queen crab2015
3161,broken horses,15000000,0,3471,-14996529,0.0002314,2015,broken horses2015
5780,a plague so pleasant,1400,0,0,-1400,0.0,2015,a plague so pleasant2015
5639,theresa is a mother,200000,0,0,-200000,0.0,2015,theresa is a mother2015
1635,trainwreck,35000000,110212700,141123897,106123897,4.032111342857143,2015,trainwreck2015
4771,amnesiac,3000000,0,0,-3000000,0.0,2015,amnesiac2015
837,maze runner the scorch trials,61000000,81697192,310566162,249566162,5.09124855737705,2015,maze runner the scorch trials2015
4480,the boy next door,4000000,36006065,53401938,49401938,13.3504845,2015,the boy next door2015
3512,la famille bãlier,11000000,0,82438670,71438670,7.494424545454545,2015,la famille bãlier2015
2879,mcfarland usa,17000000,44480275,45707924,28707924,2.688701411764706,2015,mcfarland usa2015
4767,something wicked,3000000,0,0,-3000000,0.0,2015,something wicked2015
4232,miss julie,5500000,0,863895,-4636105,0.15707181818181817,2015,miss julie2015
4766,enter the dangerous mind,3000000,0,0,-3000000,0.0,2015,enter the dangerous mind2015
5497,siakh lokhamim haslilim hagnouzim,450000,41260,42503,-407497,0.09445111111111111,2015,siakh lokhamim haslilim hagnouzim2015
1907,the age of adaline,30000000,42629776,68984536,38984536,2.299484533333333,2015,the age of adaline2015
3480,woman in gold,11000000,33307793,58586407,47586407,5.326037,2015,woman in gold2015
5,star wars ep vii the force awakens,306000000,936662225,2053311220,1747311220,6.710167385620915,2015,star wars ep vii the force awakens2015
5771,family motocross,10000,0,0,-10000,0.0,2015,family motocross2015
3550,insidious chapter 3,10000000,52218558,120453155,110453155,12.0453155,2015,insidious chapter 32015
4864,the toxic avenger part ii,2300000,0,0,-2300000,0.0,2015,the toxic avenger part ii2015
2041,the big short,28000000,70259870,133162752,105162752,4.755812571428572,2015,the big short2015
595,the last witch hunter,80000000,27367660,130818912,50818912,1.6352364,2015,the last witch hunter2015
5519,viskningar och rop,400000,0,9071,-390929,0.0226775,2015,viskningar och rop2015
4859,do you believe,2300000,12985600,14304931,12004931,6.2195352173913045,2015,do you believe2015
3206,hot tub time machine 2,14000000,12314651,12826644,-1173356,0.9161888571428571,2015,hot tub time machine 22015
819,tian jiang xiong shi,65000000,74070,122519874,57519874,1.8849211384615385,2015,tian jiang xiong shi2015
122,tomorrowland,170000000,93436322,206627518,36627518,1.2154559882352942,2015,tomorrowland2015
3027,krampus,15000000,42725475,61788393,46788393,4.1192262,2015,krampus2015
3139,cãkã niã yinniãng,15000000,632542,11279884,-3720116,0.7519922666666666,2015,cãkã niã yinniãng2015
4884,the timber,2100000,0,0,-2100000,0.0,2015,the timber2015
1899,sicario,30000000,46889293,84393749,54393749,2.8131249666666664,2015,sicario2015
5698,tiger orange,100000,0,0,-100000,0.0,2015,tiger orange2015
2911,escobar paradise lost,17000000,195792,3917679,-13082321,0.23045170588235295,2015,escobar paradise lost2015
1602,aloha,37000000,21052030,25387091,-11612909,0.6861375945945946,2015,aloha2015
4733,the d train,3000000,669688,772366,-2227634,0.2574553333333333,2015,the d train2015
2433,the transporter refueled,22000000,16029670,69698495,47698495,3.168113409090909,2015,the transporter refueled2015
4462,rl stines monsterville the cabinet of souls,4400000,0,0,-4400000,0.0,2015,rl stines monsterville the cabinet of souls2015
458,pixels,90000000,78765986,244041804,154041804,2.7115756,2015,pixels2015
5490,the little ponderosa zoo,500000,0,0,-500000,0.0,2015,the little ponderosa zoo2015
1169,run all night,50000000,26461644,66961644,16961644,1.33923288,2015,run all night2015
4291,still alice,5000000,18656400,41699612,36699612,8.3399224,2015,still alice2015
455,alvin and the chipmunks the road chip,90000000,85886987,249517956,159517956,2.772421733333333,2015,alvin and the chipmunks the road chip2015
5489,rodeo girl,500000,0,0,-500000,0.0,2015,rodeo girl2015
5487,brooklyn bizarre,500000,0,0,-500000,0.0,2015,brooklyn bizarre2015
5486,alleluia the devils carnival,500000,0,0,-500000,0.0,2015,alleluia the devils carnival2015
5482,fight to the finish,500000,0,0,-500000,0.0,2015,fight to the finish2015
5480,love in the time of monsters,500000,0,0,-500000,0.0,2015,love in the time of monsters2015
4919,we are your friends,2000000,3591417,10153415,8153415,5.0767075,2015,we are your friends2015
1590,creed,37000000,109767581,173567581,136567581,4.691015702702702,2015,creed2015
3215,suffragette,14000000,4702420,34044909,20044909,2.431779214285714,2015,suffragette2015
4275,the lazarus effect,5000000,25801570,38359310,33359310,7.671862,2015,the lazarus effect2015
2524,selma,20000000,52076908,66776576,46776576,3.3388288,2015,selma2015
5534,rotor dr1,350000,0,0,-350000,0.0,2015,rotor dr12015
5719,counting,50000,8374,8374,-41626,0.16748,2015,counting2015
832,the hateful eight,62000000,54117416,147864886,85864886,2.384917516129032,2015,the hateful eight2015
2794,ricki and the flash,18000000,26839498,41166033,23166033,2.2870018333333335,2015,ricki and the flash2015
5697,the night visitor,100000,0,0,-100000,0.0,2015,the night visitor2015
4066,criminal activities,7000000,0,386744,-6613256,0.05524914285714286,2015,criminal activities2015
4064,geroy,7000000,0,1545121,-5454879,0.22073157142857142,2015,geroy2015
4063,z storm,7000000,0,2053330,-4946670,0.2933328571428571,2015,z storm2015
428,kingsman the secret service,94000000,128261724,404561724,310561724,4.303848127659575,2015,kingsman the secret service2015
4456,zipper,4500000,0,0,-4500000,0.0,2015,zipper2015
406,the peanuts movie,99000000,130178411,250091610,151091610,2.5261778787878786,2015,the peanuts movie2015
4998,wind walkers,2000000,0,0,-2000000,0.0,2015,wind walkers2015
5007,brotherly love,1900000,478595,478595,-1421405,0.2518921052631579,2015,brotherly love2015
4950,the last five years,2000000,147299,205298,-1794702,0.102649,2015,the last five years2015
5670,the brain that sings,125000,0,0,-125000,0.0,2015,the brain that sings2015
2153,viy,26000000,0,34246770,8246770,1.3171834615384614,2015,viy2015
1856,sisters,30000000,87044645,106030660,76030660,3.5343553333333335,2015,sisters2015
5477,subconscious,500000,0,0,-500000,0.0,2015,subconscious2015
2155,the face of an angel,26000000,0,0,-26000000,0.0,2015,the face of an angel2015
4985,the lady from shanghai,2000000,0,0,-2000000,0.0,2015,the lady from shanghai2015
2277,the 33,25000000,12227722,28400715,3400715,1.1360286,2015,the 332015
148,terminator genisys,155000000,89760956,432150894,277150894,2.788070283870968,2015,terminator genisys2015
4934,the diary of a teenage girl,2000000,1477002,2279959,279959,1.1399795,2015,the diary of a teenage girl2015
5000,shark lake,2000000,0,0,-2000000,0.0,2015,shark lake2015
802,everest,65000000,43482270,221297061,156297061,3.404570169230769,2015,everest2015
5013,vaalu,1900000,0,12444,-1887556,0.006549473684210526,2015,vaalu2015
5002,the marine 4,1950000,0,0,-1950000,0.0,2015,the marine 42015
3572,the second best exotic marigold hotel,10000000,33078266,90384306,80384306,9.0384306,2015,the second best exotic marigold hotel2015
4457,the final girls,4500000,0,0,-4500000,0.0,2015,the final girls2015
1959,steve jobs,30000000,17766658,35579007,5579007,1.1859669,2015,steve jobs2015
4059,trudno byt bogom,7000000,31443,41038,-6958962,0.005862571428571429,2015,trudno byt bogom2015
5649,heroes of dirt,175000,0,0,-175000,0.0,2015,heroes of dirt2015
5422,julija in alfa romeo,560000,0,8462,-551538,0.015110714285714286,2015,julija in alfa romeo2015
3459,carol,11800000,12711491,42843521,31043521,3.6308068644067797,2015,carol2015
400,in the heart of the sea,100000000,25020758,89693309,-10306691,0.89693309,2015,in the heart of the sea2015
3478,brooklyn,11000000,38322743,62076141,51076141,5.643285545454545,2015,brooklyn2015
423,seventh son,95000000,17725785,108874967,13874967,1.1460522842105263,2015,seventh son2015
9,spectre,300000000,200074175,879620923,579620923,2.9320697433333334,2015,spectre2015
2797,love the coopers,18000000,26302731,42227490,24227490,2.345971666666667,2015,love the coopers2015
4010,dope,7000000,17506470,18190831,11190831,2.598690142857143,2015,dope2015
4070,alpha  omega the legend of the saw tooth cave,7000000,0,0,-7000000,0.0,2015,alpha  omega the legend of the saw tooth cave2015
2593,secret in their eyes,20000000,20180155,32608019,12608019,1.63040095,2015,secret in their eyes2015
1210,chappie,49000000,31569268,105002056,56002056,2.142899102040816,2015,chappie2015
1217,taken 3,48000000,89256424,327656424,279656424,6.8261755,2015,taken 32015
2777,the perfect guy,18000000,57027435,60278166,42278166,3.348787,2015,the perfect guy2015
2154,accidental love,26000000,0,135436,-25864564,0.005209076923076923,2015,accidental love2015
2533,spotlight,20000000,45055776,92088460,72088460,4.604423,2015,spotlight2015
5476,the outrageous sophie tucker,500000,0,0,-500000,0.0,2015,the outrageous sophie tucker2015
1732,the walk,35000000,10161183,61492104,26492104,1.756917257142857,2015,the walk2015
4922,captive,2000000,2583301,2791973,791973,1.3959865,2015,captive2015
5696,open secret,100000,0,0,-100000,0.0,2015,open secret2015
5694,closure,100000,0,0,-100000,0.0,2015,closure2015
3165,magic mike xxl,14500000,66013057,123660597,109160597,8.52831703448276,2015,magic mike xxl2015
1058,black mass,53000000,62575678,98837872,45837872,1.8648655094339623,2015,black mass2015
5695,lunchtime heroes,100000,0,0,-100000,0.0,2015,lunchtime heroes2015
3168,freedom,14500000,0,872757,-13627243,0.06019013793103448,2015,freedom2015
5557,the looking glass,300000,1711,1711,-298289,0.005703333333333334,2015,the looking glass2015
4751,before we go,3000000,37151,483938,-2516062,0.16131266666666666,2015,before we go2015
4186,song one,6000000,32251,437089,-5562911,0.07284816666666667,2015,song one2015
90,jupiter ascending,179000000,47482519,181982519,2982519,1.0166621173184358,2015,jupiter ascending2015
1004,paddington,55000000,76223578,258789097,203789097,4.705256309090909,2015,paddington2015
5478,roadside,500000,0,0,-500000,0.0,2015,roadside2015
1087,daddyâs home,50000000,150357137,242757137,192757137,4.85514274,2015,daddyâs home2015
3590,sinister 2,10000000,27740955,54104225,44104225,5.4104225,2015,sinister 22015
1929,entourage,30000000,32363404,46438538,16438538,1.5479512666666666,2015,entourage2015
5453,o menino e o mundo,500000,129479,280967,-219033,0.561934,2015,o menino e o mundo2015
4961,knock knock,2000000,36336,6328516,4328516,3.164258,2015,knock knock2015
4976,bone tomahawk,2000000,0,475846,-1524154,0.237923,2015,bone tomahawk2015
1559,paul blart mall cop 2,38000000,71091594,107650646,69650646,2.8329117368421053,2015,paul blart mall cop 22015
4979,to be frank sinatra at 100,2000000,0,926,-1999074,0.000463,2015,to be frank sinatra at 1002015
2403,the water diviner,22500000,4200117,31054727,8554727,1.3802100888888889,2015,the water diviner2015
3606,paranormal activity the ghost dimension,10000000,18297124,77959374,67959374,7.7959374,2015,paranormal activity the ghost dimension2015
1204,shanghai,50000000,46425,15505922,-34494078,0.31011844,2015,shanghai2015
1201,child 44,50000000,1224330,8004221,-41995779,0.16008442,2015,child 442015
5590,along the roadside,250000,0,3234,-246766,0.012936,2015,along the roadside2015
798,focus,65000000,53862963,168065700,103065700,2.585626153846154,2015,focus2015
4050,freeheld,7000000,546201,1732228,-5267772,0.24746114285714285,2015,freeheld2015
4997,the curse of downers grove,2000000,0,0,-2000000,0.0,2015,the curse of downers grove2015
2034,straight outta compton,28000000,161197785,202182981,174182981,7.22082075,2015,straight outta compton2015
3124,scouts guide to the zombie apocalypse,15000000,3703046,15554855,554855,1.0369903333333332,2015,scouts guide to the zombie apocalypse2015
138,the hunger games mockingjay  part 2,160000000,281723902,648986787,488986787,4.05616741875,2015,the hunger games mockingjay  part 22015
4995,the walking deceased,2000000,0,0,-2000000,0.0,2015,the walking deceased2015
3127,rock the kasbah,15000000,3020665,3386153,-11613847,0.22574353333333333,2015,rock the kasbah2015
4959,lost river,2000000,45431,2009644,9644,1.004822,2015,lost river2015
2535,max,20000000,42656255,43658157,23658157,2.18290785,2015,max2015
4772,unnatural,3000000,0,0,-3000000,0.0,2015,unnatural2015
4446,maggie,4500000,187112,1027760,-3472240,0.2283911111111111,2015,maggie2015
72,the good dinosaur,187500000,123087120,333771037,146271037,1.7801121973333334,2015,the good dinosaur2015
5620,the overnight,200000,1109808,1165996,965996,5.82998,2015,the overnight2015
3445,trash,12000000,17484,6553186,-5446814,0.5460988333333333,2015,trash2015
3279,room,13000000,14677674,36262783,23262783,2.789444846153846,2015,room2015
3449,san cheng ji,12000000,0,1950194,-10049806,0.16251616666666666,2015,san cheng ji2015
5652,lumea e a mea,168000,0,29678,-138322,0.1766547619047619,2015,lumea e a mea2015
3644,while were young,10000000,7582065,17503828,7503828,1.7503828,2015,while were young2015
3285,bajrangi bhaijaan,13000000,8178001,121778347,108778347,9.367565153846154,2015,bajrangi bhaijaan2015
3905,anomalisa,8000000,3759286,5706168,-2293832,0.713271,2015,anomalisa2015
4537,desert dancer,4000000,155271,596335,-3403665,0.14908375,2015,desert dancer2015
167,mission impossibleârogue nation,150000000,195042377,688858992,538858992,4.59239328,2015,mission impossibleârogue nation2015
345,the martian,108000000,228433663,655271443,547271443,6.067328175925926,2015,the martian2015
174,mad max fury road,150000000,153636354,370098020,220098020,2.467320133333333,2015,mad max fury road2015
5395,walter,700000,0,0,-700000,0.0,2015,walter2015
4665,war room,3000000,67790117,73975239,70975239,24.658413,2015,war room2015
3932,aloft,8000000,53086,237688,-7762312,0.029711,2015,aloft2015
3454,dancin its on,12000000,0,0,-12000000,0.0,2015,dancin its on2015
66,furious 7,190000000,353007020,1518722794,1328722794,7.9932778631578945,2015,furious 72015
3447,10 days in a madhouse,12000000,14616,14616,-11985384,0.001218,2015,10 days in a madhouse2015
3943,green street hooligans underground,8000000,0,0,-8000000,0.0,2015,green street hooligans underground2015
3974,outside bet,7500000,0,13524,-7486476,0.0018032,2015,outside bet2015
3367,paper towns,12000000,32000304,85450484,73450484,7.120873666666666,2015,paper towns2015
5293,the sisterhood of night,1000000,6870,6870,-993130,0.00687,2015,the sisterhood of night2015
5748,exeter,25000,0,489792,464792,19.59168,2015,exeter2015
5602,shooting the warwicks,250000,0,0,-250000,0.0,2015,shooting the warwicks2015
1782,freaks of nature,33000000,70958,70958,-32929042,0.0021502424242424243,2015,freaks of nature2015
5145,the algerian,1300000,0,0,-1300000,0.0,2015,the algerian2015
1523,victor frankenstein,40000000,5775076,31124367,-8875633,0.778109175,2015,victor frankenstein2015
5723,bending steel,50000,0,0,-50000,0.0,2015,bending steel2015
1678,hot pursuit,35000000,34580201,45671512,10671512,1.3049003428571428,2015,hot pursuit2015
4547,praia do futuro,4000000,20620,760678,-3239322,0.1901695,2015,praia do futuro2015
887,joy,60000000,56451232,101134059,41134059,1.68556765,2015,joy2015
1514,the gunman,40000000,10664749,18594227,-21405773,0.464855675,2015,the gunman2015
5724,run hide die,50000,0,0,-50000,0.0,2015,run hide die2015
3973,black november,7500000,0,32572,-7467428,0.004342933333333333,2015,black november2015
4337,90 minutes in heaven,5000000,4816142,4816142,-183858,0.9632284,2015,90 minutes in heaven2015
3975,pound of flesh,7500000,0,0,-7500000,0.0,2015,pound of flesh2015
4538,guten tag ramon,4000000,154356,4854356,854356,1.213589,2015,guten tag ramon2015
1520,baahubali the beginning,40000000,6738000,26736665,-13263335,0.668416625,2015,baahubali the beginning2015
4380,area 51,5000000,7556,7556,-4992444,0.0015112,2015,area 512015
5044,saul fia,1700000,1777043,9696537,7996537,5.703845294117647,2015,saul fia2015
673,the spongebob movie sponge out of water,74000000,162994032,311013181,237013181,4.202880824324325,2015,the spongebob movie sponge out of water2015
951,the ridiculous 6,60000000,0,0,-60000000,0.0,2015,the ridiculous 62015
3658,danny collins,10000000,5637066,8465845,-1534155,0.8465845,2015,danny collins2015
5033,beginnerâs guide to sex,1800000,0,0,-1800000,0.0,2015,beginnerâs guide to sex2015
5756,the front man,20000,0,0,-20000,0.0,2015,the front man2015
5414,drunk wedding,600000,3301,3301,-596699,0.005501666666666667,2015,drunk wedding2015
654,the man from uncle,75000000,45445109,104949584,29949584,1.3993277866666667,2015,the man from uncle2015
3302,the vatican tapes,13000000,1784763,14929184,1929184,1.1483987692307693,2015,the vatican tapes2015
5370,vessel,800000,0,0,-800000,0.0,2015,vessel2015
2372,the wedding ringer,23000000,64460211,80171596,57171596,3.4857215652173914,2015,the wedding ringer2015
5101,road hard,1500000,113169,113169,-1386831,0.075446,2015,road hard2015
2071,american ultra,28000000,14439985,30295028,2295028,1.0819652857142856,2015,american ultra2015
2319,yi ge ren de wu lin,25000000,129115,129115,-24870885,0.0051646,2015,yi ge ren de wu lin2015
3945,henry joseph church,8000000,0,0,-8000000,0.0,2015,henry joseph church2015
2626,burnt,20000000,13651946,36773510,16773510,1.8386755,2015,burnt2015
4540,manglehorn,4000000,132270,797439,-3202561,0.19935975,2015,manglehorn2015
3832,the duff,8500000,34030343,43528634,35028634,5.1210157647058825,2015,the duff2015
321,the divergent series insurgent,110000000,130179072,295075882,185075882,2.682508018181818,2015,the divergent series insurgent2015
3951,loin des hommes,7700000,5336,1080428,-6619572,0.14031532467532468,2015,loin des hommes2015
5419,irreplaceable,600000,0,0,-600000,0.0,2015,irreplaceable2015
318,san andreas,110000000,155190832,456258539,346258539,4.1478049,2015,san andreas2015
3899,me and earl and the dying girl,8000000,6758416,9266180,1266180,1.1582725,2015,me and earl and the dying girl2015
947,mortdecai,60000000,7696134,30396134,-29603866,0.5066022333333333,2015,mortdecai2015
672,minions,74000000,336045770,1160336173,1086336173,15.680218554054054,2015,minions2015
1679,concussion,35000000,34531832,50363790,15363790,1.4389654285714286,2015,concussion2015
2147,selfless,26000000,12279691,33667319,7667319,1.2948968846153845,2015,selfless2015
1827,vacation,31000000,58884188,102306500,71306500,3.300209677419355,2015,vacation2015
5105,me you and five bucks,1500000,2105,2105,-1497895,0.0014033333333333333,2015,me you and five bucks2015
3298,youth,13000000,2703296,24001573,11001573,1.846274846153846,2015,youth2015
4647,the opposite sex,3300000,0,50206,-3249794,0.015213939393939394,2015,the opposite sex2015
1368,pourquoi jai pas mangã mon pãre,42000000,0,15451663,-26548337,0.3678967380952381,2015,pourquoi jai pas mangã mon pãre2015
3271,ex machina,13000000,25440971,38358392,25358392,2.9506455384615387,2015,ex machina2015
5113,girlhouse,1500000,0,0,-1500000,0.0,2015,girlhouse2015
782,spy,65000000,110825712,232585748,167585748,3.578242276923077,2015,spy2015
5114,mutant world,1500000,0,0,-1500000,0.0,2015,mutant world2015
5115,horror,1500000,0,0,-1500000,0.0,2015,horror2015
957,goosebumps,58000000,80069458,158905324,100905324,2.7397469655172415,2015,goosebumps2015
5116,checkmate,1500000,0,0,-1500000,0.0,2015,checkmate2015
3280,woodlawn,13000000,14394097,14403703,1403703,1.1079771538461538,2015,woodlawn2015
1755,the lovers,35000000,0,53899,-34946101,0.0015399714285714286,2015,the lovers2015
1731,unfinished business,35000000,10219501,13214051,-21785949,0.3775443142857143,2015,unfinished business2015
4400,mommy,4900000,3498695,17536004,12636004,3.5787763265306123,2015,mommy2015
5345,le bonheur delza,900000,0,0,-900000,0.0,2015,le bonheur delza2015
3874,a walk in the woods,8000000,29499394,37119358,29119358,4.63991975,2015,a walk in the woods2015
5751,dutch kills,25000,0,0,-25000,0.0,2015,dutch kills2015
4640,to write love on her arms,3400000,0,0,-3400000,0.0,2015,to write love on her arms2015
192,pan,150000000,35088320,151525973,1525973,1.0101731533333334,2015,pan2015
1377,fifty shades of grey,40000000,166167230,570998101,530998101,14.274952525,2015,fifty shades of grey2015
1781,the young and prodigious ts spivet,33000000,176847,357687,-32642313,0.010839,2015,the young and prodigious ts spivet2015
3727,hross i oss,10000000,11894,11894,-9988106,0.0011894,2015,hross i oss2015
3681,testament of youth,10000000,1822250,6646669,-3353331,0.6646669,2015,testament of youth2015
5350,windsor drive,850000,3256,3256,-846744,0.0038305882352941177,2015,windsor drive2015
4352,jem and the holograms,5000000,2184640,2368937,-2631063,0.4737874,2015,jem and the holograms2015
4563,the veil,4000000,0,0,-4000000,0.0,2015,the veil2015
4633,lords of london,3440000,0,0,-3440000,0.0,2015,lords of london2015
5750,ten,25000,0,0,-25000,0.0,2015,ten2015
5671,romantic schemer,125000,0,0,-125000,0.0,2015,romantic schemer2015
4631,dawn patrol,3500000,0,0,-3500000,0.0,2015,dawn patrol2015
5137,above and beyond,1300000,288751,288751,-1011249,0.22211615384615385,2015,above and beyond2015
1707,hitman agent 47,35000000,22467450,82182803,47182803,2.348080085714286,2015,hitman agent 472015
2664,little boy,20000000,6485961,17769299,-2230701,0.88846495,2015,little boy2015
3726,strangerland,10000000,17472,161097,-9838903,0.0161097,2015,strangerland2015
2705,regression,20000000,55039,15824374,-4175626,0.7912187,2015,regression2015
5325,por amor en el caserio,1000000,0,0,-1000000,0.0,2015,por amor en el caserio2015
5323,the horror network,1000000,0,0,-1000000,0.0,2015,the horror network2015
5172,que horas ela volta,1200000,376976,3249041,2049041,2.7075341666666666,2015,que horas ela volta2015
4773,close range,3000000,0,0,-3000000,0.0,2015,close range2015
5605,411,250000,0,0,-250000,0.0,2015,4112015
1405,the intern,40000000,75764672,197115710,157115710,4.92789275,2015,the intern2015
5178,la navaja de don juan,1200000,4254,4254,-1195746,0.003545,2015,la navaja de don juan2015
2013,pitch perfect 2,29000000,184296230,287625468,258625468,9.918119586206897,2015,pitch perfect 22015
5319,the pet,1000000,0,0,-1000000,0.0,2015,the pet2015
5679,the gallows,100000,22764410,41656474,41556474,416.56474,2015,the gallows2015
1760,the longest ride,34000000,37446117,63802928,29802928,1.876556705882353,2015,the longest ride2015
5318,fear clinic,1000000,0,0,-1000000,0.0,2015,fear clinic2015
5186,bleeding hearts,1200000,0,0,-1200000,0.0,2015,bleeding hearts2015
1409,bridge of spies,40000000,72313754,162498338,122498338,4.06245845,2015,bridge of spies2015
2710,survivor,20000000,0,1703281,-18296719,0.08516405,2015,survivor2015
754,ted 2,68000000,81476385,217214143,149214143,3.194325632352941,2015,ted 22015
5155,da sweet blood of jesus,1250000,0,0,-1250000,0.0,2015,da sweet blood of jesus2015
1396,get hard,40000000,90411453,106511453,66511453,2.662786325,2015,get hard2015
4566,chain of command,4000000,0,0,-4000000,0.0,2015,chain of command2015
5332,ask me anything,950000,0,0,-950000,0.0,2015,ask me anything2015
226,the revenant,135000000,183637894,532938302,397938302,3.947691125925926,2015,the revenant2015
5659,antarctic edge 70âº south,150000,7193,7193,-142807,0.047953333333333334,2015,antarctic edge 70âº south2015
4393,capricorn one,5000000,0,0,-5000000,0.0,2015,capricorn one2015
5287,hits,1000000,15156,15156,-984844,0.015156,2015,hits2015
242,antman,130000000,180202163,518858449,388858449,3.9912188384615384,2015,antman2015
3818,skin trade,9000000,1242,1242,-8998758,0.000138,2015,skin trade2015
5296,childless,1000000,1036,1036,-998964,0.001036,2015,childless2015
5604,western religion,250000,0,0,-250000,0.0,2015,western religion2015
5660,top spin,150000,5858,5858,-144142,0.039053333333333336,2015,top spin2015
5302,american hero,1000000,0,26,-999974,2.6e-05,2015,american hero2015
5205,silent running,1100000,0,0,-1100000,0.0,2015,silent running2015
3734,american heist,10000000,0,2341218,-7658782,0.2341218,2015,american heist2015
5300,karachi se lahore,1000000,0,17721,-982279,0.017721,2015,karachi se lahore2015
2007,grace of monaco,30000000,0,25199891,-4800109,0.8399963666666667,2015,grace of monaco2015
3739,jungle shuffle,10000000,0,360898,-9639102,0.0360898,2015,jungle shuffle2015
2077,our brand is crisis,28000000,7002261,8594558,-19405442,0.3069485,2015,our brand is crisis2015
5213,unfriended,1000000,32789645,64364198,63364198,64.364198,2015,unfriended2015
3383,project almanac,12000000,22348241,32909437,20909437,2.7424530833333334,2015,project almanac2015
4392,lets kill wards wife,5000000,0,0,-5000000,0.0,2015,lets kill wards wife2015
4370,cop car,5000000,134552,143658,-4856342,0.0287316,2015,cop car2015
4396,aztec warrior,5000000,0,0,-5000000,0.0,2015,aztec warrior2015
4414,treading water,4700000,0,0,-4700000,0.0,2015,treading water2015
5120,mustang,1400000,845464,5552584,4152584,3.9661314285714284,2015,mustang2015
4391,born of war,5000000,0,0,-5000000,0.0,2015,born of war2015
4397,navy seal vs zombies,5000000,0,0,-5000000,0.0,2015,navy seal vs zombies2015
3746,into the grizzly maze,10000000,0,0,-10000000,0.0,2015,into the grizzly maze2015
2326,red sky,25000000,0,91116,-24908884,0.00364464,2015,red sky2015
3820,veronika decides to die,9000000,0,2243,-8997757,0.00024922222222222224,2015,veronika decides to die2015
2684,my allamerican,20000000,2246000,2246000,-17754000,0.1123,2015,my allamerican2015
5278,beyond the brick a lego brickumentary,1000000,101531,101531,-898469,0.101531,2015,beyond the brick a lego brickumentary2015
4399,running forever,5000000,0,0,-5000000,0.0,2015,running forever2015
3779,black or white,9000000,21571189,21971021,12971021,2.4412245555555554,2015,black or white2015
5600,give me shelter,250000,0,0,-250000,0.0,2015,give me shelter2015
2005,united passions,30000000,918,168832,-29831168,0.005627733333333333,2015,united passions2015
2696,by the sea,20000000,538460,3727746,-16272254,0.1863873,2015,by the sea2015
746,blackhat,70000000,8005980,19665004,-50334996,0.2809286285714286,2015,blackhat2015
2004,wild card,30000000,3200,4315789,-25684211,0.14385963333333332,2015,wild card2015
5230,the green inferno,1000000,7192291,12931420,11931420,12.93142,2015,the green inferno2015
5598,undivided,250000,0,0,-250000,0.0,2015,undivided2015
1090,central intelligence,50000000,127440871,217194805,167194805,4.3438961,2016,central intelligence2016
1021,kubo and the two strings,55000000,48023088,77548122,22548122,1.4099658545454545,2016,kubo and the two strings2016
2880,almost christmas,17000000,42065185,42493506,25493506,2.499618,2016,almost christmas2016
4253,10 cloverfield lane,5000000,72082999,108286422,103286422,21.6572844,2016,10 cloverfield lane2016
2853,forsaken,18000000,0,0,-18000000,0.0,2016,forsaken2016
2849,i am wrath,18000000,0,309608,-17690392,0.017200444444444445,2016,i am wrath2016
4824,hunt for the wilderpeople,2500000,5205471,23845533,21345533,9.5382132,2016,hunt for the wilderpeople2016
2835,miss sloane,18000000,3500605,7719630,-10280370,0.42886833333333335,2016,miss sloane2016
2226,motherâs day,25000000,32492859,52367022,27367022,2.09468088,2016,motherâs day2016
4254,lights out,5000000,67268835,148806510,143806510,29.761302,2016,lights out2016
4720,compadres,3000000,3127773,7445044,4445044,2.4816813333333334,2016,compadres2016
618,the little prince,77500000,1311213,102028919,24528919,1.3165021806451613,2016,the little prince2016
4880,mi america,2100000,3330,3330,-2096670,0.0015857142857142858,2016,mi america2016
1144,war dogs,50000000,43034523,86234503,36234503,1.72469006,2016,war dogs2016
625,the secret life of pets,75000000,368384330,886750534,811750534,11.823340453333333,2016,the secret life of pets2016
2163,hidden figures,25000000,169607287,231771716,206771716,9.27086864,2016,hidden figures2016
4062,oddball,7000000,0,10237229,3237229,1.4624612857142858,2016,oddball2016
2916,the young messiah,16800000,6469813,7313697,-9486303,0.4353391071428571,2016,the young messiah2016
4708,donât think twice,3000000,4417983,4417983,1417983,1.472661,2016,donât think twice2016
4709,swiss army man,3000000,4210454,5837111,2837111,1.9457036666666667,2016,swiss army man2016
4848,antibirth,2500000,0,0,-2500000,0.0,2016,antibirth2016
1178,snowden,50000000,21587519,35380918,-14619082,0.70761836,2016,snowden2016
1180,free state of jones,50000000,20810036,23237252,-26762748,0.46474504,2016,free state of jones2016
2964,bleed for this,16000000,5083906,6603926,-9396074,0.412745375,2016,bleed for this2016
4849,the rise of the krays,2500000,0,0,-2500000,0.0,2016,the rise of the krays2016
3314,operation chromite,12700000,1022720,49196532,36496532,3.8737426771653545,2016,operation chromite2016
2834,midnight special,18000000,3712282,7680250,-10319750,0.42668055555555556,2016,midnight special2016
327,passengers,110000000,100014699,302239672,192239672,2.747633381818182,2016,passengers2016
3227,reign of assassins,14000000,0,11354230,-2645770,0.8110164285714285,2016,reign of assassins2016
4657,the meddler,3200000,4267219,5526942,2326942,1.727169375,2016,the meddler2016
676,the angry birds movie,73000000,107509366,352327887,279327887,4.826409410958904,2016,the angry birds movie2016
329,miss peregrineâs home for peculiar children,110000000,87242834,295986876,185986876,2.690789781818182,2016,miss peregrineâs home for peculiar children2016
5086,unsullied,1500000,510957,510957,-989043,0.340638,2016,unsullied2016
5084,31,1500000,779820,922727,-577273,0.6151513333333334,2016,312016
5080,iâm not ashamed,1500000,2082980,2082980,582980,1.3886533333333333,2016,iâm not ashamed2016
333,the divergent series allegiant,110000000,66184051,172022517,62022517,1.5638410636363635,2016,the divergent series allegiant2016
3930,a street cat named bob,8000000,82703,17382693,9382693,2.172836625,2016,a street cat named bob2016
346,allied,106000000,40098064,119266661,13266661,1.125157179245283,2016,allied2016
351,ice age collision course,105000000,64063008,402156682,297156682,3.830063638095238,2016,ice age collision course2016
5063,moonlight,1500000,27854931,65245512,63745512,43.497008,2016,moonlight2016
3946,code of honor,8000000,0,0,-8000000,0.0,2016,code of honor2016
2508,tyler perryâs boo a madea halloween,20000000,73206343,73206343,53206343,3.66031715,2016,tyler perryâs boo a madea halloween2016
3249,miracles from heaven,13000000,61705123,73798736,60798736,5.6768258461538466,2016,miracles from heaven2016
628,sing,75000000,270329045,634454789,559454789,8.459397186666667,2016,sing2016
3129,the disappointments room,15000000,2423467,3503761,-11496239,0.23358406666666667,2016,the disappointments room2016
1129,13 hours the secret soldiers of benghazi,50000000,52853219,69411370,19411370,1.3882274,2016,13 hours the secret soldiers of benghazi2016
4284,godâs not dead 2,5000000,20773069,23551286,18551286,4.7102572,2016,godâs not dead 22016
4865,eden,2300000,0,0,-2300000,0.0,2016,eden2016
2909,genius,17000000,1361045,7265283,-9734717,0.42736958823529414,2016,genius2016
4146,the lady in the van,6000000,10021175,42320503,36320503,7.053417166666667,2016,the lady in the van2016
4738,the bounce back,3000000,321910,421404,-2578596,0.140468,2016,the bounce back2016
454,the magnificent seven,90000000,93432655,162525156,72525156,1.8058350666666667,2016,the magnificent seven2016
309,the huntsman winterâs war,115000000,48003015,165149302,50149302,1.4360808869565218,2016,the huntsman winterâs war2016
980,zhuo yao ji,56000000,32766,359495591,303495591,6.419564125,2016,zhuo yao ji2016
4385,yoga hosers,5000000,0,22958,-4977042,0.0045916,2016,yoga hosers2016
285,jason bourne,120000000,162192920,416168316,296168316,3.4680693,2016,jason bourne2016
735,the finest hours,70000000,27569558,49252761,-20747239,0.7036108714285715,2016,the finest hours2016
1394,ride along 2,40000000,90862685,124827316,84827316,3.1206829,2016,ride along 22016
4614,american honey,3500000,663247,2611750,-888250,0.7462142857142857,2016,american honey2016
3774,ouija origin of evil,9000000,35144505,81831866,72831866,9.092429555555556,2016,ouija origin of evil2016
3811,dheepan,9000000,248795,7704357,-1295643,0.8560396666666666,2016,dheepan2016
1746,a hologram for the king,35000000,4212494,11846010,-23153990,0.3384574285714286,2016,a hologram for the king2016
5675,une femme mariãe,120000,0,0,-120000,0.0,2016,une femme mariãe2016
3838,middle school the worst years of my life,8500000,20007149,23311293,14811293,2.7425050588235296,2016,middle school the worst years of my life2016
1416,hacksaw ridge,40000000,67209615,168904682,128904682,4.22261705,2016,hacksaw ridge2016
714,storks,70000000,72679278,183353431,113353431,2.6193347285714284,2016,storks2016
5737,krisha,30000,144822,144822,114822,4.8274,2016,krisha2016
1389,the conjuring 2 the enfield poltergeist,40000000,102470008,311262102,271262102,7.78155255,2016,the conjuring 2 the enfield poltergeist2016
231,teenage mutant ninja turtles out of the shadows,135000000,82051601,245328374,110328374,1.8172472148148149,2016,teenage mutant ninja turtles out of the shadows2016
272,trolls,125000000,153707064,344150134,219150134,2.753201072,2016,trolls2016
3803,greater,9000000,2000093,2000093,-6999907,0.22223255555555554,2016,greater2016
2097,money monster,27000000,41012075,93466095,66466095,3.461707222222222,2016,money monster2016
3359,lion,12000000,51739495,149570720,137570720,12.464226666666667,2016,lion2016
44,rogue one a star wars story,200000000,532177324,1049102856,849102856,5.24551428,2016,rogue one a star wars story2016
4612,believe,3500000,890303,890303,-2609697,0.2543722857142857,2016,believe2016
4348,the other side of the door,5000000,3000342,12905107,7905107,2.5810214,2016,the other side of the door2016
3904,morgan,8000000,3915251,7298786,-701214,0.91234825,2016,morgan2016
3376,hell or high water,12000000,27007844,37584304,25584304,3.1320253333333334,2016,hell or high water2016
2808,norm of the north,18000000,17062499,30535660,12535660,1.6964255555555556,2016,norm of the north2016
2711,the history of love,20000000,0,476624,-19523376,0.0238312,2016,the history of love2016
1399,the accountant,40000000,86260045,152962083,112962083,3.824052075,2016,the accountant2016
465,now you see me 2,90000000,65075540,328325007,238325007,3.648055633333333,2016,now you see me 22016
4289,race,5000000,19115191,23745772,18745772,4.7491544,2016,race2016
1163,zoolander 2,50000000,28848693,55348693,5348693,1.10697386,2016,zoolander 22016
4899,hardcore henry,2000000,9252038,17187434,15187434,8.593717,2016,hardcore henry2016
1155,the nice guys,50000000,36261763,59596747,9596747,1.19193494,2016,the nice guys2016
4885,sharkskin,2100000,0,0,-2100000,0.0,2016,sharkskin2016
4345,green room,5000000,3220371,3807503,-1192497,0.7615006,2016,green room2016
1280,office christmas party,45000000,54767494,91323299,46323299,2.0294066444444443,2016,office christmas party2016
3786,jackie,9000000,13960394,36588512,27588512,4.065390222222222,2016,jackie2016
5221,hello my name is doris,1000000,14444999,14662703,13662703,14.662703,2016,hello my name is doris2016
17,batman v superman dawn of justice,250000000,330360194,867500281,617500281,3.470001124,2016,batman v superman dawn of justice2016
16,captain america civil war,250000000,408084349,1140069413,890069413,4.560277652,2016,captain america civil war2016
3850,acorns operation crackdown,8500000,0,1353287,-7146713,0.15921023529411765,2016,acorns operation crackdown2016
1772,mike and dave need wedding dates,33000000,46009673,75898100,42898100,2.2999424242424245,2016,mike and dave need wedding dates2016
2542,nerve,20000000,38583626,70652284,50652284,3.5326142,2016,nerve2016
3791,loving,9000000,7710234,12898064,3898064,1.4331182222222223,2016,loving2016
4615,the bronze,3500000,615816,615816,-2884184,0.17594742857142856,2016,the bronze2016
4618,the masked saint,3500000,182695,182695,-3317305,0.05219857142857143,2016,the masked saint2016
3785,the edge of seventeen,9000000,14431633,19096003,10096003,2.121778111111111,2016,the edge of seventeen2016
4353,paterson,5000000,2141423,10727536,5727536,2.1455072,2016,paterson2016
5153,bodom,1250000,0,726460,-523540,0.581168,2016,bodom2016
279,assassinâs creed,125000000,54647948,240759682,115759682,1.926077456,2016,assassinâs creed2016
1738,the brothers grimsby,35000000,6864016,28720470,-6279530,0.8205848571428571,2016,the brothers grimsby2016
2714,fight valley,20000000,0,0,-20000000,0.0,2016,fight valley2016
4338,incarnate,5000000,4799774,9371036,4371036,1.8742072,2016,incarnate2016
3829,manchester by the sea,8500000,47695371,77733867,69233867,9.145160823529412,2016,manchester by the sea2016
3105,queen of katwe,15000000,8874389,10055481,-4944519,0.6703654,2016,queen of katwe2016
2519,me before you,20000000,56245075,208265198,188265198,10.4132599,2016,me before you2016
1612,collateral beauty,36000000,31016021,85309093,49309093,2.369697027777778,2016,collateral beauty2016
1705,whiskey tango foxtrot,35000000,23083334,25350747,-9649253,0.7243070571428571,2016,whiskey tango foxtrot2016
1468,patriots day,40000000,31886361,52837989,12837989,1.320949725,2016,patriots day2016
816,live by night,65000000,10378555,21774432,-43225568,0.33499126153846154,2016,live by night2016
125,alice through the looking glass,170000000,77042381,276928112,106928112,1.6289888941176471,2016,alice through the looking glass2016
1702,bridget jonesâs baby,35000000,24139805,205822688,170822688,5.880648228571428,2016,bridget jonesâs baby2016
2073,pride and prejudice and zombies,28000000,10907291,16638300,-11361700,0.594225,2016,pride and prejudice and zombies2016
5338,meet the blacks,900000,9097072,9097072,8197072,10.107857777777777,2016,meet the blacks2016
3649,shut in,10000000,6900335,11360665,1360665,1.1360665,2016,shut in2016
1568,the 5th wave,38000000,34912982,111336398,73336398,2.9299052105263157,2016,the 5th wave2016
127,doctor strange,165000000,232641920,676404566,511404566,4.099421612121212,2016,doctor strange2016
3584,when the bough breaks,10000000,29747603,30768449,20768449,3.0768449,2016,when the bough breaks2016
2016,the boss,29000000,63077560,78652207,49652207,2.7121450689655173,2016,the boss2016
2651,ratchet and clank,20000000,8813410,14365639,-5634361,0.71828195,2016,ratchet and clank2016
4431,the lobster,4500000,9196278,18019834,13519834,4.004407555555556,2016,the lobster2016
3665,denial,10000000,4073448,9263940,-736060,0.926394,2016,denial2016
4461,airlift 2016,4400000,0,9969237,5569237,2.2657356818181817,2016,airlift 20162016
3666,the man who knew infinity,10000000,3877922,12382122,2382122,1.2382122,2016,the man who knew infinity2016
132,independence day resurgence,165000000,103144286,384169424,219169424,2.328299539393939,2016,independence day resurgence2016
3567,the boy,10000000,35819556,68220952,58220952,6.8220952,2016,the boy2016
2646,popstar never stop never stopping,20000000,9496130,9537120,-10462880,0.476856,2016,popstar never stop never stopping2016
1493,mechanic resurrection,40000000,21218403,109738840,69738840,2.743471,2016,mechanic resurrection2016
2336,fences,24000000,57682904,64282881,40282881,2.678453375,2016,fences2016
3668,everybody wants some,10000000,3400278,5437126,-4562874,0.5437126,2016,everybody wants some2016
4398,the hatching,5000000,0,0,-5000000,0.0,2016,the hatching2016
156,zootopia,150000000,341268248,1019429616,869429616,6.79619744,2016,zootopia2016
2727,sausage party,19000000,97670358,141344255,122344255,7.439171315789474,2016,sausage party2016
3755,dangal,9500000,12391761,294654618,285154618,31.01627557894737,2016,dangal2016
87,the legend of tarzan,180000000,126643061,348902025,168902025,1.9383445833333333,2016,the legend of tarzan2016
1619,yip man 3,36000000,2679437,157300954,121300954,4.369470944444444,2016,yip man 32016
1529,billy lynnâs long halftime walk,40000000,1738477,30230402,-9769598,0.75576005,2016,billy lynnâs long halftime walk2016
84,fantastic beasts and where to find them,180000000,234037575,802402853,622402853,4.457793627777778,2016,fantastic beasts and where to find them2016
145,warcraft,160000000,47225655,425522281,265522281,2.65951425625,2016,warcraft2016
146,deepwater horizon,156000000,61433527,122603824,-33396176,0.7859219487179487,2016,deepwater horizon2016
841,mei ren yu,60720000,3229457,554516671,493796671,9.13235624176548,2016,mei ren yu2016
216,the bfg,140000000,55483770,199646680,59646680,1.4260477142857142,2016,the bfg2016
3069,keanu,15000000,20591853,20688141,5688141,1.3792094,2016,keanu2016
3514,misconduct,11000000,0,2352511,-8647489,0.21386463636363637,2016,misconduct2016
217,gods of egypt,140000000,31153464,138836756,-1163244,0.9916911142857143,2016,gods of egypt2016
1539,uss indianapolis men of courage,40000000,0,1663785,-38336215,0.041594625,2016,uss indianapolis men of courage2016
5415,they will have to kill us first,600000,0,7943,-592057,0.013238333333333333,2016,they will have to kill us first2016
3461,dirty grandpa,11500000,35593113,105078449,93578449,9.137256434782609,2016,dirty grandpa2016
3456,the dressmaker,11900000,2022115,24041617,12141617,2.020303949579832,2016,the dressmaker2016
5273,the invitation,1000000,231738,354836,-645164,0.354836,2016,the invitation2016
5281,creative control,1000000,63014,63014,-936986,0.063014,2016,creative control2016
879,london has fallen,60000000,62524260,195194085,135194085,3.25323475,2016,london has fallen2016
210,kung fu panda 3,140000000,143528619,517599142,377599142,3.6971367285714285,2016,kung fu panda 32016
2021,florence foster jenkins,29000000,27383770,56000339,27000339,1.931046172413793,2016,florence foster jenkins2016
2402,nocturnal animals,22500000,10663357,32398681,9898681,1.4399413777777779,2016,nocturnal animals2016
161,moana,150000000,248757044,637517365,487517365,4.250115766666666,2016,moana2016
3667,max steel,10000000,3818664,4563080,-5436920,0.456308,2016,max steel2016
3499,sultan,11000000,5599781,72989781,61989781,6.6354346363636365,2016,sultan2016
2673,hands of stone,20000000,4712792,5031975,-14968025,0.25159875,2016,hands of stone2016
3287,robinson crusoe,13000000,8005586,42446455,29446455,3.265111923076923,2016,robinson crusoe2016
3967,the neon demon,7500000,1333124,3559803,-3940197,0.4746404,2016,the neon demon2016
1820,criminal,31500000,14708696,38771262,7271262,1.2308337142857142,2016,criminal2016
4321,the perfect match,5000000,9669521,10182050,5182050,2.03641,2016,the perfect match2016
45,finding dory,200000000,486295561,1021215193,821215193,5.106075965,2016,finding dory2016
2754,out of the inferno,19000000,0,0,-19000000,0.0,2016,out of the inferno2016
3274,eye in the sky,13000000,18704596,35402802,22402802,2.7232924615384615,2016,eye in the sky2016
955,deadpool,58000000,363070709,801025593,743025593,13.810786086206896,2016,deadpool2016
663,inferno,75000000,34343574,219519367,144519367,2.926924893333333,2016,inferno2016
2498,bad moms,20000000,113257297,180998716,160998716,9.0499358,2016,bad moms2016
4314,fifty shades of black,5000000,11686940,22113075,17113075,4.422615,2016,fifty shades of black2016
4999,the dog lover,2000000,0,0,-2000000,0.0,2016,the dog lover2016
4307,hillaryâs america the secret history of the democratic party,5000000,13099931,13099931,8099931,2.6199862,2016,hillaryâs america the secret history of the democratic party2016
1241,silence,46500000,7100177,23726626,-22773374,0.5102500215053763,2016,silence2016
1233,arrival,47000000,100546139,203127894,156127894,4.321870085106383,2016,arrival2016
2776,my big fat greek wedding 2,18000000,59689605,92096558,74096558,5.116475444444444,2016,my big fat greek wedding 22016
3253,the shallows,13000000,55121623,118763442,105763442,9.135649384615384,2016,the shallows2016
1267,the girl on the train,45000000,75395035,174278214,129278214,3.8728492,2016,the girl on the train2016
5650,the fits,170000,166425,169242,-758,0.9955411764705883,2016,the fits2016
2311,jane got a gun,25000000,1513793,3771345,-21228655,0.1508538,2016,jane got a gun2016
950,xi you ji zhi sun wu kong san da bai gu jing,60000000,709982,194058503,134058503,3.2343083833333335,2016,xi you ji zhi sun wu kong san da bai gu jing2016
2521,barbershop the next cut,20000000,54030051,54404202,34404202,2.7202101,2016,barbershop the next cut2016
2118,rules donât apply,26700000,3652206,3871448,-22828552,0.14499805243445693,2016,rules donât apply2016
4593,the witch,3500000,25138705,40454520,36954520,11.558434285714286,2016,the witch2016
4621,time to choose,3500000,29233,29233,-3470767,0.008352285714285715,2016,time to choose2016
1231,the infiltrator,47500000,15436808,20718104,-26781896,0.4361706105263158,2016,the infiltrator2016
849,sully,60000000,125070033,238524556,178524556,3.9754092666666665,2016,sully2016
78,star trek beyond,185000000,158848340,335802233,150802233,1.8151472054054054,2016,star trek beyond2016
2421,hail caesar,22000000,30080225,64160680,42160680,2.9163945454545455,2016,hail caesar2016
5385,adulterers,750000,0,0,-750000,0.0,2016,adulterers2016
92,xmen apocalypse,178000000,155442489,542537546,364537546,3.047963741573034,2016,xmen apocalypse2016
1561,why him,38000000,60323786,117425156,79425156,3.0901356842105265,2016,why him2016
2008,savva serdtse voyna,30000000,0,5015080,-24984920,0.16716933333333334,2016,savva serdtse voyna2016
3600,blair witch,10000000,20777061,38985577,28985577,3.8985577,2016,blair witch2016
2385,eddie the eagle,23000000,15789389,45060480,22060480,1.9591513043478261,2016,eddie the eagle2016
2632,triple 9,20000000,12639297,25943792,5943792,1.2971896,2016,triple 92016
2491,la la land,20000000,151101803,426351163,406351163,21.31755815,2016,la la land2016
99,suicide squad,175000000,325100054,746059887,571059887,4.263199354285715,2016,suicide squad2016
3712,kicks,10000000,150191,150191,-9849809,0.0150191,2016,kicks2016
2547,risen,20000000,36880033,46255763,26255763,2.31278815,2016,risen2016
4497,the darkness,4000000,10753574,10898293,6898293,2.72457325,2016,the darkness2016
3538,donât breathe,10000000,89217875,158973685,148973685,15.8973685,2016,donât breathe2016
5324,chemical cut,1000000,0,0,-1000000,0.0,2016,chemical cut2016
1597,how to be single,37000000,46843513,100003780,63003780,2.702804864864865,2016,how to be single2016
5321,hush,1000000,0,0,-1000000,0.0,2016,hush2016
884,jack reacher never go back,60000000,58697076,159946489,99946489,2.6657748166666666,2016,jack reacher never go back2016
5322,1982,1000000,0,0,-1000000,0.0,2016,19822016
3541,the purge election year,10000000,79042440,118514727,108514727,11.8514727,2016,the purge election year2016
3591,the forest,10000000,26594261,40749230,30749230,4.074923,2016,the forest2016
3596,kevin hart what now,10000000,23591043,23591043,13591043,2.3591043,2016,kevin hart what now2016
1655,neighbors 2 sorority rising,35000000,55340730,108757621,73757621,3.1073606,2016,neighbors 2 sorority rising2016
2633,the light between oceans,20000000,12545979,22281732,2281732,1.1140866,2016,the light between oceans2016
2538,the star,20000000,40847995,62758010,42758010,3.1379005,2017,the star2017
2322,matilda,25000000,0,9370285,-15629715,0.3748114,2017,matilda2017
3682,free fire,10000000,1799322,3793739,-6206261,0.3793739,2017,free fire2017
313,ferdinand,111000000,84410380,289847930,178847930,2.6112426126126125,2017,ferdinand2017
2647,thank you for your service,20000000,9479390,9985316,-10014684,0.4992658,2017,thank you for your service2017
4344,table 19,5000000,3614896,4620399,-379601,0.9240798,2017,table 192017
704,daddyâs home 2,70000000,104029443,175807183,105807183,2.511531185714286,2017,daddyâs home 22017
3690,churchill,10000000,1279681,7582196,-2417804,0.7582196,2017,churchill2017
1680,the foreigner,35000000,34393507,140783360,105783360,4.022381714285714,2017,the foreigner2017
1483,resident evil the final chapter,40000000,26844692,314101190,274101190,7.85252975,2017,resident evil the final chapter2017
1350,snatched,42000000,45852178,57852177,15852177,1.3774327857142856,2017,snatched2017
1340,a monster calls,43000000,3740823,46414530,3414530,1.0794076744186047,2017,a monster calls2017
1480,the nut job 2 nutty by nature,40000000,28370522,57438389,17438389,1.435959725,2017,the nut job 2 nutty by nature2017
4553,perfectos desconocidos,4000000,0,31166312,27166312,7.791578,2017,perfectos desconocidos2017
1983,the space between us,30000000,7885294,16481405,-13518595,0.5493801666666667,2017,the space between us2017
1690,underworld blood wars,35000000,30353973,81209222,46209222,2.320263485714286,2017,underworld blood wars2017
1981,the lost city of z,30000000,8574339,17121823,-12878177,0.5707274333333333,2017,the lost city of z2017
191,the great wall,150000000,45157105,334486852,184486852,2.2299123466666666,2017,the great wall2017
24,pirates of the caribbean dead men tell no tales,230000000,172558876,788241137,558241137,3.4271353782608696,2017,pirates of the caribbean dead men tell no tales2017
2020,logan lucky,29000000,27778642,44264271,15264271,1.526354172413793,2017,logan lucky2017
353,kingsman the golden circle,104000000,100234838,408803696,304803696,3.930804769230769,2017,kingsman the golden circle2017
1393,john wick chapter two,40000000,92029184,171350009,131350009,4.283750225,2017,john wick chapter two2017
293,power rangers,120000000,85364450,142531552,22531552,1.1877629333333333,2017,power rangers2017
2715,the thousand miles,20000000,0,0,-20000000,0.0,2017,the thousand miles2017
5334,lowriders,916000,6179955,6188421,5272421,6.755918122270742,2017,lowriders2017
3056,home again,15000000,27020284,37336874,22336874,2.489124933333333,2017,home again2017
22,the fate of the furious,250000000,225764765,1234846267,984846267,4.939385068,2017,the fate of the furious2017
168,dunkirk,150000000,190068280,499837368,349837368,3.33224912,2017,dunkirk2017
280,monster trucks,125000000,33370166,61642798,-63357202,0.493142384,2017,monster trucks2017
5685,a ghost story,100000,1594798,2769782,2669782,27.69782,2017,a ghost story2017
2307,tulip fever,25000000,2455635,6792768,-18207232,0.27171072,2017,tulip fever2017
4320,the belko experiment,5000000,10166820,11792942,6792942,2.3585884,2017,the belko experiment2017
3976,the bye bye man,7400000,22395806,31187727,23787727,4.214557702702702,2017,the bye bye man2017
1989,stronger,30000000,4211129,8786752,-21213248,0.29289173333333335,2017,stronger2017
1290,all eyez on me,45000000,44922302,54876855,9876855,1.2194856666666667,2017,all eyez on me2017
4536,polina danser sa vie,4000000,165203,953314,-3046686,0.2383285,2017,polina danser sa vie2017
2718,the shape of water,19500000,63859435,195790794,176290794,10.040553538461538,2017,the shape of water2017
894,the dark tower,60000000,50701325,113461527,53461527,1.89102545,2017,the dark tower2017
885,baywatch,60000000,58060186,175863783,115863783,2.93106305,2017,baywatch2017
270,the boss baby,125000000,175003033,510878762,385878762,4.087030096,2017,the boss baby2017
2803,the circle,18000000,20497844,40651864,22651864,2.258436888888889,2017,the circle2017
2398,chäi dã n zhuänjiä,23000000,0,58807172,35807172,2.5568335652173912,2017,chäi dã n zhuänjiä2017
1833,birth of the dragon,31000000,6901965,7220490,-23779510,0.2329190322580645,2017,birth of the dragon2017
4003,gifted,7000000,24801212,36964656,29964656,5.280665142857143,2017,gifted2017
3089,the founder,15000000,12786053,24403192,9403192,1.6268794666666666,2017,the founder2017
1257,pitch perfect 3,45000000,104897530,185736412,140736412,4.127475822222222,2017,pitch perfect 32017
154,wonder woman,150000000,412563408,821133378,671133378,5.47422252,2017,wonder woman2017
151,war for the planet of the apes,152000000,146880162,489592267,337592267,3.2210017565789473,2017,war for the planet of the apes2017
4311,before i fall,5000000,12241072,18945682,13945682,3.7891364,2017,before i fall2017
4925,the resurrection of gavin stone,2000000,2303792,2303792,303792,1.151896,2017,the resurrection of gavin stone2017
1758,baby driver,34000000,107825862,228104185,194104185,6.708946617647059,2017,baby driver2017
4074,two lovers and a bear,6840000,0,22273,-6817727,0.0032562865497076025,2017,two lovers and a bear2017
1558,captain underpants the first epic movie,38000000,73921000,126577874,88577874,3.3309966842105263,2017,captain underpants the first epic movie2017
5188,the islands,1200000,0,0,-1200000,0.0,2017,the islands2017
2494,wonder,20000000,132422809,304604712,284604712,15.2302356,2017,wonder2017
761,downsizing,68000000,24449754,54462971,-13537029,0.800926044117647,2017,downsizing2017
2479,bitter harvest,21000000,557241,606162,-20393838,0.028864857142857143,2017,bitter harvest2017
3849,posledniy bogatyr,8500000,0,30700192,22200192,3.611787294117647,2017,posledniy bogatyr2017
904,smurfs the lost village,60000000,45020282,197578586,137578586,3.292976433333333,2017,smurfs the lost village2017
946,rock dog,60000000,9420546,24148488,-35851512,0.4024748,2017,rock dog2017
3574,how to be a latin lover,10000000,32149404,62556228,52556228,6.2556228,2017,how to be a latin lover2017
3599,the disaster artist,10000000,21120616,28717667,18717667,2.8717667,2017,the disaster artist2017
2472,victoria and abdul,21000000,22245070,68271146,47271146,3.251006952380952,2017,victoria and abdul2017
79,blade runner 2049,185000000,92054159,259357408,74357408,1.4019319351351351,2017,blade runner 20492017
629,despicable me 3,75000000,264624300,1034727750,959727750,13.79637,2017,despicable me 32017
1864,the hitmanâs bodyguard,30000000,75468583,172778667,142778667,5.7592889,2017,the hitmanâs bodyguard2017
2468,kidnap,21000000,30718107,34836080,13836080,1.6588609523809523,2017,kidnap2017
398,geostorm,100000000,33700160,220796009,120796009,2.20796009,2017,geostorm2017
2275,battle of the sexes,25000000,12638526,18445379,-6554621,0.73781516,2017,battle of the sexes2017
4962,growing up smith,2000000,35312,35312,-1964688,0.017656,2017,growing up smith2017
411,alien covenant,97000000,74262031,238521247,141521247,2.4589819278350515,2017,alien covenant2017
2530,tyler perryâs boo 2 a madea halloween,20000000,47319572,47879572,27879572,2.3939786,2017,tyler perryâs boo 2 a madea halloween2017
3406,marshall,12000000,10051659,10116816,-1883184,0.843068,2017,marshall2017
4303,it comes at night,5000000,13985117,19720203,14720203,3.9440406,2017,it comes at night2017
437,jumanji welcome to the jungle,90000000,404508916,964496193,874496193,10.716624366666666,2017,jumanji welcome to the jungle2017
4702,let there be light,3000000,7233471,7241309,4241309,2.4137696666666666,2017,let there be light2017
258,logan,127000000,226277068,615461394,488461394,4.846152708661418,2017,logan2017
5645,arrowhead,180000,0,0,-180000,0.0,2017,arrowhead2017
1574,only the brave,38000000,18340051,24555177,-13444823,0.6461888684210526,2017,only the brave2017
2012,collide,29200000,2280004,5466698,-23733302,0.18721568493150684,2017,collide2017
339,ghost in the shell,110000000,40563557,167910690,57910690,1.5264608181818182,2017,ghost in the shell2017
2606,the zookeeperâs wife,20000000,17445186,26308749,6308749,1.31543745,2017,the zookeeperâs wife2017
3938,don gato el inicio de la pandilla,8000000,0,4604656,-3395344,0.575582,2017,don gato el inicio de la pandilla2017
2586,rough night,20000000,22105643,46844357,26844357,2.34221785,2017,rough night2017
2426,diary of a wimpy kid the long haul,22000000,20738724,35609577,13609577,1.6186171363636364,2017,diary of a wimpy kid the long haul2017
2035,girls trip,28000000,115108515,140886353,112886353,5.0316554642857145,2017,girls trip2017
1893,atomic blonde,30000000,51573925,98345423,68345423,3.2781807666666665,2017,atomic blonde2017
479,bright,90000000,0,0,-90000000,0.0,2017,bright2017
3001,annabelle creation,15000000,102092201,305384865,290384865,20.358991,2017,annabelle creation2017
477,the promise,90000000,8224288,10551417,-79448583,0.11723796666666667,2017,the promise2017
3396,wish upon,12000000,14301505,23477345,11477345,1.9564454166666667,2017,wish upon2017
990,fifty shades darker,55000000,114434010,381398492,326398492,6.934518036363636,2017,fifty shades darker2017
89,valerian and the city of a thousand planets,180000000,40479370,215098356,35098356,1.1949908666666667,2017,valerian and the city of a thousand planets2017
1621,queen of the desert,36000000,0,1578543,-34421457,0.04384841666666667,2017,queen of the desert2017
524,the greatest showman,84000000,174340174,386665550,302665550,4.603161309523809,2017,the greatest showman2017
4263,the big sick,5000000,42872467,53972860,48972860,10.794572,2017,the big sick2017
1935,mollyâs game,30000000,28780744,53296424,23296424,1.7765474666666667,2017,mollyâs game2017
3160,in dubious battle,15000000,0,214182,-14785818,0.0142788,2017,in dubious battle2017
1623,it,35000000,327481748,697457969,662457969,19.927370542857144,2017,it2017
2237,rings,25000000,27793018,82917283,57917283,3.31669132,2017,rings2017
5744,emily,27000,3547,3547,-23453,0.13137037037037036,2017,emily2017
4094,same kind of different as me,6500000,6423605,6423605,-76395,0.9882469230769231,2017,same kind of different as me2017
4910,the florida project,2000000,5904366,11295324,9295324,5.647662,2017,the florida project2017
5392,columbus,700000,1017107,1110511,410511,1.5864442857142858,2017,columbus2017
3134,the comedian,15000000,1658706,1658706,-13341294,0.1105804,2017,the comedian2017
2681,lbj,20000000,2468683,2507181,-17492819,0.12535905,2017,lbj2017
8,justice league,300000000,229024295,655945209,355945209,2.18648403,2017,justice league2017
2039,a bad moms christmas,28000000,72110659,127710550,99710550,4.561091071428572,2017,a bad moms christmas2017
3482,i tonya,11000000,30014534,53797409,42797409,4.890673545454545,2017,i tonya2017
2912,mune le gardien de la lune,17000000,0,14534046,-2465954,0.8549438823529412,2017,mune le gardien de la lune2017
3552,lady bird,10000000,48958273,78610769,68610769,7.8610769,2017,lady bird2017
1131,american made,50000000,51342000,135569212,85569212,2.71138424,2017,american made2017
1485,the house,40000000,25584504,31192425,-8807575,0.779810625,2017,the house2017
3560,jigsaw,10000000,38052832,102445196,92445196,10.2445196,2017,jigsaw2017
3569,everything everything,10000000,34121140,61603136,51603136,6.1603136,2017,everything everything2017
2255,father figures,25000000,17501244,21038441,-3961559,0.84153764,2017,father figures2017
3358,three billboards outside ebbing missouri,12000000,54513740,160191915,148191915,13.34932625,2017,three billboards outside ebbing missouri2017
719,the lego ninjago movie,70000000,59281555,122737201,52737201,1.7533885857142857,2017,the lego ninjago movie2017
2252,chips,25000000,18600152,23190292,-1809708,0.92761168,2017,chips2017
4911,all saints,2000000,5802208,5941994,3941994,2.970997,2017,all saints2017
1946,ballerina,30000000,21858070,96892829,66892829,3.2297609666666665,2017,ballerina2017
4755,demonic,3000000,0,4668109,1668109,1.5560363333333334,2017,demonic2017
5231,i am not your negro,1000000,7123919,9617402,8617402,9.617402,2017,i am not your negro2017
540,the lego batman movie,80000000,175750384,310660018,230660018,3.883250225,2017,the lego batman movie2017
2339,going in style,24000000,45018541,78672579,54672579,3.278024125,2017,going in style2017
994,murder on the orient express,55000000,102826543,345922730,290922730,6.289504181818182,2017,murder on the orient express2017
2228,fist fight,25000000,32187017,40286416,15286416,1.61145664,2017,fist fight2017
101,coco,175000000,209726015,798008101,623008101,4.560046291428572,2017,coco2017
1739,the snowman,35000000,6670765,43226146,8226146,1.2350327428571428,2017,the snowman2017
5238,an inconvenient sequel,1000000,3496795,5839322,4839322,5.839322,2017,an inconvenient sequel2017
98,spiderman homecoming,175000000,334201140,880166350,705166350,5.029522,2017,spiderman homecoming2017
4846,sky sharks,2500000,0,0,-2500000,0.0,2017,sky sharks2017
4586,utãya 22 juli,3600000,0,173156,-3426844,0.048098888888888885,2017,utãya 22 juli2017
827,american assassin,63000000,36249674,68310140,5310140,1.0842879365079365,2017,american assassin2017
2839,t2 trainspotting,18000000,2402004,42091262,24091262,2.3384034444444444,2017,t2 trainspotting2017
1954,baahubali 2 the conclusion,30000000,18985794,263502914,233502914,8.783430466666667,2017,baahubali 2 the conclusion2017
2439,roman j israel esq,22000000,11962712,12967012,-9032988,0.5894096363636364,2017,roman j israel esq2017
4458,daisy winters,4500000,0,0,-4500000,0.0,2017,daisy winters2017
5202,departure,1100000,0,27561,-1072439,0.025055454545454544,2017,departure2017
1883,darkest hour,30000000,56443120,150807172,120807172,5.026905733333333,2017,darkest hour2017
2185,a dogâs purpose,25000000,64321890,203671625,178671625,8.146865,2017,a dogâs purpose2017
4,star wars ep viii the last jedi,317000000,620181382,1316721747,999721747,4.153696362776025,2017,star wars ep viii the last jedi2017
1958,mother,30000000,17800004,42531076,12531076,1.4177025333333333,2017,mother2017
32,transformers the last knight,217000000,130168683,602893340,385893340,2.778310322580645,2017,transformers the last knight2017
1106,the emoji movie,50000000,86089513,216562312,166562312,4.33124624,2017,the emoji movie2017
104,cars 3,175000000,152901115,383541369,208541369,2.1916649657142857,2017,cars 32017
4249,split,5000000,138141585,278964806,273964806,55.7929612,2017,split2017
4248,get out,5000000,176040665,255367951,250367951,51.0735902,2017,get out2017
5571,sleight,250000,3930990,3934450,3684450,15.7378,2017,sleight2017
4242,the girl with all the gifts,5250000,0,4801837,-448163,0.914635619047619,2017,the girl with all the gifts2017
48,guardians of the galaxy vol 2,200000000,389813101,862316233,662316233,4.311581165,2017,guardians of the galaxy vol 22017
2443,just getting started,22000000,6069605,6756412,-15243588,0.30710963636363636,2017,just getting started2017
81,thor ragnarok,180000000,315058289,846980024,666980024,4.705444577777778,2017,thor ragnarok2017
5255,patti cake,1000000,800148,1471090,471090,1.47109,2017,patti cake2017
2694,jãyã dã shä,20000000,587470,43888531,23888531,2.19442655,2017,jãyã dã shä2017
4728,the wall,3000000,1803064,4495262,1495262,1.4984206666666666,2017,the wall2017
110,king arthur legend of the sword,175000000,39175066,139630336,-35369664,0.7978876342857143,2017,king arthur legend of the sword2017
4257,happy death day,5000000,55683845,125010260,120010260,25.002052,2017,happy death day2017
1108,the post,50000000,81903458,179748880,129748880,3.5949776,2017,the post2017
5253,visages villages,1000000,952432,4015686,3015686,4.015686,2017,visages villages2017
3747,friend request,9900000,3759078,11310835,1410835,1.142508585858586,2017,friend request2017
77,kong skull island,185000000,168052812,561072059,376072059,3.0328219405405403,2017,kong skull island2017
514,xxx return of xander cage,85000000,44898413,345033359,260033359,4.0592159882352945,2017,xxx return of xander cage2017
4346,thoroughbreds,5000000,3072605,3187302,-1812698,0.6374604,2018,thoroughbreds2018
2259,mary queen of scots,25000000,16468499,46734733,21734733,1.86938932,2018,mary queen of scots2018
483,the predator,88000000,51024708,159487563,71487563,1.8123586704545454,2018,the predator2018
5400,that way madness lies,650000,1447,1447,-648553,0.002226153846153846,2018,that way madness lies2018
4894,eighth grade,2000000,13539710,14341016,12341016,7.170508,2018,eighth grade2018
469,tomb raider,90000000,58250803,273477501,183477501,3.0386389,2018,tomb raider2018
443,spiderman into the spiderverse 3d,90000000,190173195,375381768,285381768,4.170908533333333,2018,spiderman into the spiderverse 3d2018
4924,hearts beat loud,2000000,2386254,2420962,420962,1.210481,2018,hearts beat loud2018
277,skyscraper,125000000,68420120,304115534,179115534,2.432924272,2018,skyscraper2018
2377,the hate u give,23000000,29719483,35067665,12067665,1.5246810869565217,2018,the hate u give2018
5069,unsane,1500000,7690044,14244931,12744931,9.496620666666667,2018,unsane2018
403,mortal engines,100000000,15951040,85287417,-14712583,0.85287417,2018,mortal engines2018
149,pacific rim uprising,155000000,59874525,290930148,135930148,1.8769686967741936,2018,pacific rim uprising2018
177,ready player one,150000000,137690172,579290136,429290136,3.86193424,2018,ready player one2018
2784,uncle drew,18000000,42469946,46527161,28527161,2.5848422777777778,2018,uncle drew2018
1357,holmes  watson,42000000,30568743,41926605,-73395,0.9982525,2018,holmes  watson2018
1339,the girl in the spiderâs web,43000000,14828555,34983342,-8016658,0.8135660930232558,2018,the girl in the spiderâs web2018
3294,ben is back,13000000,3703182,9633111,-3366889,0.7410085384615385,2018,ben is back2018
357,a wrinkle in time,103000000,100478608,133401882,30401882,1.2951639029126214,2018,a wrinkle in time2018
1317,welcome to marwen,45000000,10763520,12874922,-32125078,0.2861093777777778,2018,welcome to marwen2018
3940,backstabbing for beginners,8000000,0,343773,-7656227,0.042971625,2018,backstabbing for beginners2018
3923,london fields,8000000,252676,433732,-7566268,0.0542165,2018,london fields2018
1798,i feel pretty,32000000,48795601,91553797,59553797,2.86105615625,2018,i feel pretty2018
4594,winchester,3500000,25091816,44378040,40878040,12.67944,2018,winchester2018
1688,adrift,35000000,31445011,57897191,22897191,1.654205457142857,2018,adrift2018
1763,the darkest minds,34000000,12695691,38361428,4361428,1.128277294117647,2018,the darkest minds2018
1415,the house with a clock in its walls,40000000,68549695,126331750,86331750,3.15829375,2018,the house with a clock in its walls2018
3360,overboard,12000000,50316123,85369830,73369830,7.1141525,2018,overboard2018
3804,destroyer,9000000,1533324,3681096,-5318904,0.4090106666666667,2018,destroyer2018
1449,widows,40000000,42402632,73866088,33866088,1.8466522,2018,widows2018
3395,if beale street could talk,12000000,14915773,19859167,7859167,1.6549305833333334,2018,if beale street could talk2018
3912,lean on pete,8000000,1163056,2455027,-5544973,0.306878375,2018,lean on pete2018
4597,forever my girl,3500000,16376066,16376066,12876066,4.678876,2018,forever my girl2018
93,the meg,178000000,145443742,529530715,351530715,2.974891657303371,2018,the meg2018
2680,suspiria,20000000,2483472,7034615,-12965385,0.35173075,2018,suspiria2018
620,the equalizer 2,77000000,102084362,190453132,113453132,2.473417298701299,2018,the equalizer 22018
5466,higher power,500000,528,528,-499472,0.001056,2018,higher power2018
2749,action point,19000000,5059608,5103675,-13896325,0.26861447368421054,2018,action point2018
314,deadpool 2,110000000,324591735,786680557,676680557,7.151641427272727,2018,deadpool 22018
5176,blood feast,1200000,8708,8708,-1191292,0.0072566666666666665,2018,blood feast2018
2580,on the basis of sex,20000000,24622687,38073377,18073377,1.90366885,2018,on the basis of sex2018
627,dr seussâ the grinch,75000000,270620950,511002426,436002426,6.81336568,2018,dr seussâ the grinch2018
5119,werk ohne autor,1400000,1303747,4331152,2931152,3.09368,2018,werk ohne autor2018
568,smallfoot,80000000,83240103,213691277,133691277,2.6711409625,2018,smallfoot2018
4792,indivisible,2700000,3511417,3588305,888305,1.3290018518518518,2018,indivisible2018
2737,nobodyâs fool,19000000,31713110,32589493,13589493,1.7152364736842105,2018,nobodyâs fool2018
2865,a quiet place,17000000,188024361,334522294,317522294,19.677782,2018,a quiet place2018
112,jurassic world fallen kingdom,170000000,417719760,1305772799,1135772799,7.681016464705882,2018,jurassic world fallen kingdom2018
1809,bad times at the el royale,32000000,17839115,29204379,-2795621,0.91263684375,2018,bad times at the el royale2018
5107,teefa in trouble,1500000,0,98806,-1401194,0.06587066666666666,2018,teefa in trouble2018
4688,upgrade,3000000,11977130,16553285,13553285,5.517761666666667,2018,upgrade2018
642,christopher robin,75000000,99215042,197504758,122504758,2.633396773333333,2018,christopher robin2018
2716,bird box,19800000,0,0,-19800000,0.0,2018,bird box2018
2305,sgt stubby an american hero,25000000,3054285,3645957,-21354043,0.14583828,2018,sgt stubby an american hero2018
234,the nutcracker and the four realms,132900000,54858851,170293899,37393899,1.281368690744921,2018,the nutcracker and the four realms2018
244,mary poppins returns,130000000,171958438,341528518,211528518,2.627142446153846,2018,mary poppins returns2018
361,bumblebee,102000000,127195589,465195589,363195589,4.5607410686274505,2018,bumblebee2018
240,antman and the wasp,130000000,216648740,623144660,493144660,4.793420461538462,2018,antman and the wasp2018
5228,unfriended dark web,1000000,8866745,16434588,15434588,16.434588,2018,unfriended dark web2018
2294,beautiful boy,25000000,7634767,13031424,-11968576,0.52125696,2018,beautiful boy2018
135,aquaman,160000000,335061807,1146894640,986894640,7.1680915,2018,aquaman2018
2220,peppermint,25000000,35418723,51800758,26800758,2.07203032,2018,peppermint2018
102,ralph breaks the internet,175000000,201091711,524283695,349283695,2.9959068285714285,2018,ralph breaks the internet2018
2982,second act,15700000,39282227,63288854,47588854,4.031137197452229,2018,second act2018
4610,first reformed,3500000,3448256,3874772,374772,1.1070777142857142,2018,first reformed2018
4653,sorry to bother you,3200000,17493096,18285560,15085560,5.7142375,2018,sorry to bother you2018
289,rampage,120000000,101028233,428056280,308056280,3.5671356666666667,2018,rampage2018
2948,superfly,16000000,20537137,20723581,4723581,1.2952238125,2018,superfly2018
2370,green book,23000000,85080171,322034439,299034439,14.001497347826087,2018,green book2018
3969,borg vs mcenroe,7500000,231346,3257922,-4242078,0.4343896,2018,borg vs mcenroe2018
3555,hereditary,10000000,44069456,70133905,60133905,7.0133905,2018,hereditary2018
3663,gotti,10000000,4286367,6089100,-3910900,0.60891,2018,gotti2018
4294,paul apostle of christ,5000000,17547999,25529498,20529498,5.1058996,2018,paul apostle of christ2018
4278,the strangers prey at night,5000000,24431472,29960051,24960051,5.9920102,2018,the strangers prey at night2018
3248,the first purge,13000000,69488745,136617305,123617305,10.509023461538462,2018,the first purge2018
1096,peter rabbit,50000000,115234093,347136477,297136477,6.94272954,2018,peter rabbit2018
1197,early man,50000000,8267544,45285890,-4714110,0.9057178,2018,early man2018
1887,life of the party,30000000,53059911,65759911,35759911,2.191997033333333,2018,life of the party2018
1902,den of thieves,30000000,44947622,80131391,50131391,2.671046366666667,2018,den of thieves2018
4118,breaking in,6000000,46840590,51411620,45411620,8.568603333333334,2018,breaking in2018
4136,the possession of hannah grace,6000000,14836174,42785387,36785387,7.130897833333333,2018,the possession of hannah grace2018
1922,the 1517 to paris,30000000,36276286,56096200,26096200,1.8698733333333333,2018,the 1517 to paris2018
1099,the mule,50000000,103804407,170857676,120857676,3.41715352,2018,the mule2018
1927,death wish,30000000,34017028,48575965,18575965,1.6191988333333334,2018,death wish2018
996,fifty shades freed,55000000,100407760,371350619,316350619,6.751829436363637,2018,fifty shades freed2018
1095,creed ii,50000000,115715889,213591522,163591522,4.27183044,2018,creed ii2018
4170,mandy,6000000,1214525,1427656,-4572344,0.23794266666666666,2018,mandy2018
1078,alpha,51000000,35851379,99624873,48624873,1.953428882352941,2018,alpha2018
1941,white boy rick,30000000,24004833,25947983,-4052017,0.8649327666666666,2018,white boy rick2018
11,solo a star wars story,275000000,213767512,393151347,118151347,1.4296412618181817,2018,solo a star wars story2018
1461,the commuter,40000000,36343858,101985431,61985431,2.549635775,2018,the commuter2018
59,fantastic beasts the crimes of grindelwald,200000000,159555901,652220086,452220086,3.26110043,2018,fantastic beasts the crimes of grindelwald2018
5777,red 11,7000,0,0,-7000,0.0,2018,red 112018
43,incredibles 2,200000000,608581744,1242520711,1042520711,6.212603555,2018,incredibles 22018
2534,acrimony,20000000,43549096,46627836,26627836,2.3313918,2018,acrimony2018
751,red sparrow,69000000,46874505,145951861,76951861,2.1152443623188404,2018,red sparrow2018
6,avengers infinity war,300000000,678815482,2048134200,1748134200,6.827114,2018,avengers infinity war2018
41,black panther,200000000,700059566,1348258224,1148258224,6.74129112,2018,black panther2018
698,oceanâs 8,70000000,140218711,297115976,227115976,4.244513942857143,2018,oceanâs 82018
91,mission impossibleâfallout,178000000,220159104,787456552,609456552,4.4239132134831465,2018,mission impossibleâfallout2018
1949,proud mary,30000000,20868638,21709539,-8290461,0.7236513,2018,proud mary2018
1031,annihilation,55000000,32732301,43070915,-11929085,0.7831075454545454,2018,annihilation2018
4219,hell fest,5500000,11107431,18119231,12619231,3.2944056363636363,2018,hell fest2018
2523,a simple favor,20000000,53548586,97628717,77628717,4.88143585,2018,a simple favor2018
4574,hevi reissu,3800000,10153,10153,-3789847,0.002671842105263158,2018,hevi reissu2018
2459,blockers,21000000,60311495,94045328,73045328,4.478348952380952,2018,blockers2018
3020,blackkklansman,15000000,49275340,93017335,78017335,6.201155666666667,2018,blackkklansman2018
1541,the crow,40000000,0,0,-40000000,0.0,2018,the crow2018
3583,teen titans go to the movies,10000000,29790236,51620593,41620593,5.1620593,2018,teen titans go to the movies2018
3579,slender man,10000000,30564825,51723644,41723644,5.1723644,2018,slender man2018
1663,12 strong,35000000,45819713,71118378,36118378,2.031953657142857,2018,12 strong2018
1581,the sisters brothers,38000000,3143056,13143056,-24856944,0.3458698947368421,2018,the sisters brothers2018
3639,can you ever forgive me,10000000,8803865,11752387,1752387,1.1752387,2018,can you ever forgive me2018
1677,mile 22,35000000,36108758,66295121,31295121,1.8941463142857142,2018,mile 222018
1662,goosebumps 2 haunted halloween,35000000,46697321,93291478,58291478,2.6654708,2018,goosebumps 2 haunted halloween2018
1658,sicario day of the soldado,35000000,50065850,75885196,40885196,2.1681484571428573,2018,sicario day of the soldado2018
3544,insidious the last key,10000000,67745330,167885588,157885588,16.7885588,2018,insidious the last key2018
3542,book club,10000000,68566296,91113683,81113683,9.1113683,2018,book club2018
1604,a star is born,36000000,215288866,433449571,397449571,12.040265861111111,2018,a star is born2018
1593,game night,37000000,69179066,117378084,80378084,3.1723806486486485,2018,game night2018
776,hotel transylvania 3 summer vacation,65000000,167500092,527079962,462079962,8.108922492307693,2018,hotel transylvania 3 summer vacation2018
3556,love simon,10000000,40826341,65520633,55520633,6.5520633,2018,love simon2018
1521,the hurricane heist,40000000,6115824,30963684,-9036316,0.7740921,2018,the hurricane heist2018
1837,crazy rich asians,30000000,174532921,238099711,208099711,7.936657033333334,2018,crazy rich asians2018
1219,instant family,48000000,67363237,119736188,71736188,2.4945039166666665,2018,instant family2018
820,air strike,65000000,0,516279,-64483721,0.007942753846153847,2018,air strike2018
2049,tag,28000000,54730625,77026186,49026186,2.750935214285714,2018,tag2018
839,maze runner the death cure,61000000,58032443,265878536,204878536,4.358664524590164,2018,maze runner the death cure2018
983,bohemian rhapsody,55000000,216303339,894985342,839985342,16.272460763636364,2018,bohemian rhapsody2018
3989,i can only imagine,7000000,83482352,85604221,78604221,12.22917442857143,2018,i can only imagine2018
899,vice,60000000,47836282,70883171,10883171,1.1813861833333332,2018,vice2018
905,first man,60000000,44936545,105203825,45203825,1.7533970833333334,2018,first man2018
3038,the favourite,15000000,34366783,94113929,79113929,6.274261933333333,2018,the favourite2018
1987,kin,30000000,5718096,10096821,-19903179,0.3365607,2018,kin2018
3114,hotel artemis,15000000,6708137,12758799,-2241201,0.8505866,2018,hotel artemis2018
4328,fahrenheit 119,5000000,6352306,6653715,1653715,1.330743,2018,fahrenheit 1192018
953,sherlock gnomes,59000000,43242871,87527651,28527651,1.4835195084745763,2018,sherlock gnomes2018
2015,night school,29000000,77339130,103008792,74008792,3.5520273103448274,2018,night school2018
4590,truth or dare,3500000,41411015,95127344,91627344,27.179241142857144,2018,truth or dare2018
1999,bilal a new breed of hero,30000000,490973,648599,-29351401,0.021619966666666667,2018,bilal a new breed of hero2018
2487,us,20000000,175006930,254210310,234210310,12.7105155,2019,us2019
407,the lego movie 2 the second part,99000000,105806508,190325698,91325698,1.922481797979798,2019,the lego movie 2 the second part2019
3871,the intruder,8000000,35095904,36005871,28005871,4.500733875,2019,the intruder2019
922,cold pursuit,60000000,32138862,62599159,2599159,1.0433193166666668,2019,cold pursuit2019
4534,late night,4000000,246305,246305,-3753695,0.06157625,2019,late night2019
2915,crawl,17000000,0,0,-17000000,0.0,2019,crawl2019
670,playmobil,75000000,0,0,-75000000,0.0,2019,playmobil2019
840,a dogâs way home,61000000,41952715,81149689,20149689,1.3303227704918033,2019,a dogâs way home2019
2029,unhinged,29000000,0,0,-29000000,0.0,2019,unhinged2019
2520,what men want,20000000,54611903,69911903,49911903,3.49559515,2019,what men want2019
619,renegades,77500000,0,1521672,-75978328,0.01963447741935484,2019,renegades2019
3080,miss bala,15000000,14998027,15362298,362298,1.0241532,2019,miss bala2019
671,355,75000000,0,0,-75000000,0.0,2019,3552019
3915,el chicano,8000000,700261,700261,-7299739,0.087532625,2019,el chicano2019
1208,ad astra,49800000,0,0,-49800000,0.0,2019,ad astra2019
3947,burn your maps,8000000,0,0,-8000000,0.0,2019,burn your maps2019
341,men in black international,110000000,3100000,3100000,-106900000,0.028181818181818183,2019,men in black international2019
1305,uglydolls,45000000,19894664,24644664,-20355336,0.5476592,2019,uglydolls2019
1829,isnât it romantic,31000000,48791187,48791187,17791187,1.5739092580645162,2019,isnât it romantic2019
4012,brightburn,7000000,16794432,27989498,20989498,3.9984997142857144,2019,brightburn2019
1207,the rhythm section,50000000,0,0,-50000000,0.0,2019,the rhythm section2019
1206,arctic dogs,50000000,0,0,-50000000,0.0,2019,arctic dogs2019
5047,braid,1660000,0,80745,-1579255,0.04864156626506024,2019,braid2019
5037,living dark the story of ted the caver,1750000,0,0,-1750000,0.0,2019,living dark the story of ted the caver2019
393,wonder park,100000000,45216793,115149422,15149422,1.15149422,2019,wonder park2019
2296,captive state,25000000,5958315,8993300,-16006700,0.359732,2019,captive state2019
4132,unplanned,6000000,18107621,18107621,12107621,3.017936833333333,2019,unplanned2019
4135,the prodigy,6000000,14856291,19789712,13789712,3.2982853333333333,2019,the prodigy2019
3163,blinded by the light,15000000,0,0,-15000000,0.0,2019,blinded by the light2019
3312,rogue city,13000000,0,0,-13000000,0.0,2019,rogue city2019
580,the secret life of pets 2,80000000,63795655,113351496,33351496,1.4168937,2019,the secret life of pets 22019
1584,the upside,37500000,108235497,119024536,81524536,3.1739876266666665,2019,the upside2019
954,the kid who would be king,59000000,16790790,28348446,-30651554,0.48048213559322034,2019,the kid who would be king2019
3835,dragon ball super broly,8500000,30376755,122747755,114247755,14.440912352941176,2019,dragon ball super broly2019
255,how to train your dragon the hidden world,129000000,160791800,519258283,390258283,4.025258007751938,2019,how to train your dragon the hidden world2019
2325,the professor and the madman,25000000,0,5227233,-19772767,0.20908932,2019,the professor and the madman2019
2499,glass,20000000,111035005,245303505,225303505,12.26517525,2019,glass2019
3795,the sun is also a star,9000000,4950029,5434029,-3565971,0.603781,2019,the sun is also a star2019
2329,reagan,25000000,0,0,-25000000,0.0,2019,reagan2019
3515,eli,11000000,0,0,-11000000,0.0,2019,eli2019
2,dark phoenix,350000000,42762350,149762350,-200237650,0.42789242857142856,2019,dark phoenix2019
3531,pmc deo beongkeo,10300000,0,12478635,2178635,1.2115179611650486,2019,pmc deo beongkeo2019
95,captain marvel,175000000,426525952,1123061550,948061550,6.417494571428572,2019,captain marvel2019
121,dumbo,170000000,113883318,345004422,175004422,2.0294377764705884,2019,dumbo2019
3485,fighting with my family,11000000,22958583,39049922,28049922,3.5499929090909093,2019,fighting with my family2019
952,midway,59500000,0,0,-59500000,0.0,2019,midway2019
3777,happy death day 2u,9000000,28051045,64179495,55179495,7.131055,2019,happy death day 2u2019
123,alita battle angel,170000000,85710210,402976036,232976036,2.3704472705882353,2019,alita battle angel2019
175,pokãmon detective pikachu,150000000,139507806,411258433,261258433,2.7417228866666665,2019,pokãmon detective pikachu2019
496,shazam,85000000,139606856,362899733,277899733,4.2694086235294115,2019,shazam2019
4265,ma,5000000,36049540,44300625,39300625,8.860125,2019,ma2019
480,army of the dead,90000000,0,0,-90000000,0.0,2019,army of the dead2019
1370,rocketman,41000000,57342725,108642725,67642725,2.64982256097561,2019,rocketman2019
2481,velvet buzzsaw,21000000,0,0,-21000000,0.0,2019,velvet buzzsaw2019
1380,john wick chapter 3 â parabellum,40000000,141744320,256498033,216498033,6.412450825,2019,john wick chapter 3 â parabellum2019
3990,five feet apart,7000000,45729221,80504421,73504421,11.500631571428572,2019,five feet apart2019
1474,long shot,40000000,30202860,43711031,3711031,1.092775775,2019,long shot2019
3633,the best of enemies,10000000,10205616,10205616,205616,1.0205616,2019,the best of enemies2019
1538,kursk,40000000,0,4212799,-35787201,0.105319975,2019,kursk2019
1542,the goldfinch,40000000,0,0,-40000000,0.0,2019,the goldfinch2019
1543,down under cover,40000000,0,0,-40000000,0.0,2019,down under cover2019
124,godzilla king of the monsters,170000000,85576941,299276941,129276941,1.760452594117647,2019,godzilla king of the monsters2019
194,moonfall,150000000,0,0,-150000000,0.0,2020,moonfall2020
1205,hannibal the conqueror,50000000,0,0,-50000000,0.0,2020,hannibal the conqueror2020
535,call of the wild,82000000,0,0,-82000000,0.0,2020,call of the wild2020
